ASV1	ITS2 Extracted ITS2 sequence 56-251 (196 bp)	GAACTATAACGCACTTGGGGATTGTGCCCAGGAGGCTGTCTTGAAGTGGGGAATGCTTGCCTTTTGTGCTGTCTGTCAGGTAGTCGGCTGTTCCTTTGGGGTCCTGTGTGCACCTGTCTTGGGCTTTAGCATGTTGGGTAGGCTTCTCTGAAATGCATTTGTGAGTGTTGCTTGCGACTTGCTCTGTTGGGTTTAT
ASV2	ITS2 Extracted ITS2 sequence 56-251 (196 bp)	GAACTATAACGCACTTGGGGATTGTGCCCAGGAGTGGGGAATGCTTGCCTTTTGTGCTGTCTGTCAGGTAGTCGGCTGTTCCTTTGGGGTCCTGTGTGCACCTGTCTTGGGCTTTAGCATGTTGGGTAGGCTTCTCTGAAATGCATTTGTGAGTGTTGCTTGTGACTTGCTCTGTTGGGTTTATAGGCGTCATAGT
ASV3	ITS2 Extracted ITS2 sequence 56-222 (167 bp)	CAACCCTCGAACCCCTCCGGGGGGTCGGCGTTGGGGATCGGCCCTTTACGGGGCCGGCCCCGAAATACAGTGGCGGTCTCGCCGCAGCCTCTCCTGCGCAGTAGTTTGCACACTCGCATCGGGAGCGCGGCGCGTCCACAGCCGTTAAACACCCCAAACTTCTGAAA
ASV4	ITS2 Extracted ITS2 sequence 56-222 (167 bp)	CAACCCTCGAACCCCTCCGGGGGGTCGGCGTTGGGGATCGGCCCTTTACGGGGCCGGCCCCGAAATACAGTGGCGGTCTCGCCGCAGCCTCTCCTGCGCAGTAGTTTGCACACTCGCATCGGGAGCGCGGCGCGTCCACAGCCGTTAAACACCCCAAACTTCTGAAA
ASV5	ITS2 Extracted ITS2 sequence 56-230 (175 bp)	CAACCCTCGAACCCCTCCGGGGGGTCGGCGTTGGGGATGCGGGAACCCCTAAGACGGGATCCCGGCCCCGAAATACAGTGGCGGTCTCGCCGCAGCCTCTCCTGCGCAGTAGTTTGCACAACTCGCACCGGGAGCGCGGCGCGTCCACGTCCGTAAAACACCCAACTTTCTGAAA
ASV6	ITS2 Extracted ITS2 sequence 56-222 (167 bp)	CAACCCTCGAACCCCTCCGGGGGGTCGGCGTTGGGGATCGGCCCTTTACGGGGCCGGCCCCGAAATACAGTGGCGGTCTCGCCGCAGCCTCTCCTGCGCAGTAGTTTGCACACTCGCATCGGGAGCGCGGCGCGTCCACAGCCGTTAAACACCCCAAACTTCTGAAA
ASV7	ITS2 Extracted ITS2 sequence 56-251 (196 bp)	CTCTCTCAAACCTTCGGGTTTGGTATTGAGTGATACTCTTAGTCGGACTAGGCGTTTGCTTGAAATTTATTGGCATGAGTGATGCTAAGAAGTGCATTCAGGAAATATCAATGTATTAGGTTTATCCAACTCGTTGACAATTCTTGGTTGTGAATTTTTAGTGTTAGGCTTTGCCTTAAAAAACAACAAACAAGTT
ASV8	ITS2 Extracted ITS2 sequence 56-222 (167 bp)	TCTCTCAACCAATAGGGTTTCTTATTGGCTTGGATCTGGGTGTTGCCAGCTTTGTCTGGCTCGCCTTAAAGGAGTTAGCGAGTAAAGCTCTGTCGTCTGGCGTAATAAGTTTCGCTGGTGTAGACATGTGTGGCGCACGCTTATAATCGCCCTCGGGCAATTTTTGA
ASV9	ITS2 Extracted ITS2 sequence 56-251 (196 bp)	GAACTCTAACGCACTTGGGGATTGTGCCCAGGAGGCTGTCTTGAAGTGGGGAATGCTTGCCTTTTGTGCTGTCTGTCAGGTAGTCGGCTGTTCCTTTGGGGTCCTGTGTGCACCTGTCTTGGGCTTTAGCATGTTGGGTAGGCTTCTCTGAAATGCATTTGTGAGTGTTGCTTGCGACTTGCTCTGTTGGGTTTAT
ASV10	ITS2 Extracted ITS2 sequence 56-222 (167 bp)	CAACCCTCGAACCCCTCCGGGGGGTCGGCGTTGGGGATCGGCCCTTTACGGGGCCGGCCCCGAAATACAGTGGCGGTCTCGCCGCAGCCTCTCCTGCGCAGTAGTTTGCACACTCGCATCGGGAGCGCGGCGCGTCCACAGCCGGTAAACACCCCAAACTTCTGAAA
ASV11	ITS2 Extracted ITS2 sequence 55-251 (197 bp)	TGAACCATAACGCACTTGGGAATTGTGCCCAGGAGGCTGTCTTGAAGTGGAGAATGCTTGCCTTTTGTGCTGTCTGTCAGGTAGTCGGCCGTTCCTTCGGGGTTCTGCGTGCACCTGTCTTGGGCTTTAGCAGGTTGGGTAGGCTTCTCTGAAATGCATTTGTGAGTGTTGCTTGCGACTTGCTCTGTTGGGTTTAT
ASV12	ITS2 Extracted ITS2 sequence 56-221 (166 bp)	CTGCCCTCAAGCCCGGCTTGTGTGTTGGGCCCCGTCCCCCCCGCCGGGGGGACGGGCCCGAAAGGCAGCGGCGGCACCGCGTCCGGTCCTCGAGCGTATGGGGCTTCGTCACCCGCTCTAGTAGGCCCGGCCGGCGCCAGCCGACCCCCAACCTTTAATTATCTCA
ASV13	ITS2 Extracted ITS2 sequence 56-222 (167 bp)	CAACCCTCGAACCCCTCCGGGGGGTCGGCGTTGGGGATCGGCCCTTTACGGGGCCGGCCCCGAAATACAGTGGCGGTCTCGCCGCAGCCTCTCCTGCGCAGTAGTTTGCACACTCGCATCGGGAGCGCGGCGCGTCCACAGCCGGTAAACACCCCAAACTTCTGAAA
ASV14	ITS2 Extracted ITS2 sequence 56-251 (196 bp)	CAACCCTCGAACCCCTCCGGGGGGTCGGCGTTGGGGATGCGGGAACCCCTAAGACGGGATCCCGGCCCCGAAATACAGTGGCGGTCTCGCCGCAGCCTCTCCTGCGCAGTAGTTTGCACAACTCGCACCGGGAGCGCGGCGCGTCCACGTCCGTAAAACACCCAACTTTCTGAAATGTTGACCTCGGATCAGGGAG
ASV15	ITS2 Extracted ITS2 sequence 56-251 (196 bp)	GAACCATAATGCACTTGGGAATTGTGCCCAGGAGGCTGTCTTGAAGTGGGGAATGCTTGCCTTTTGTGCTGTCTGTCAGGTAGTCGGCCGTTCCTTCGGGGTTCTGCGTGCACCTGTCTTGGGCTTTAGCAGGTTGGGTAGGCTTCTCTGAAATGCATTTGTGAGTGTTGCTTGCGACTTGCTCTGTTGGGTTTAT
ASV16	ITS2 Extracted ITS2 sequence 56-222 (167 bp)	CAACCCTCGAACCCCTCCGGGGGGTCGGCGTTGGGGATCGGCCCTTTACGGGGCCGGCCCCGAAATACAGTGGCGGTCTCGCCGCAGCCTCTCCTGCGCCGTAGTTTGCACACTCGCATCGGGAGCGCGGCGCGTCCACAGCCGTTAAACACCCCAAACTTCTGAAA
ASV17	ITS2 Extracted ITS2 sequence 56-204 (149 bp)	CAACCCTCAAGCACAGCTTGGTGTTGGGACTCGCGTTAATTCGCGTTCCTCAAACTGATTGGCGGTCACGTCGAGCTTCCATAGCGTAGTAGTAAAACCCTCGTTACTGGTAATCGTCGCGGCCACGCCGTTAAACCCCAACTTCTGAA
ASV18	ITS2 Extracted ITS2 sequence 56-230 (175 bp)	CAACCCTCGAACCCCTCCGGGGGGTCGGCGTTGGGGATGCGGGAACCCCTAAGACGGGATCCCGGCCCCGAAATACAGTGGCGGTCTCGCCGCAGCCTCTCCTGCGCAGTAGTTTGCACAACTCGCACCCGGAGCGCGGCGCGTCCACGTCCGTAAAACACCCAACTTTCTGAAA
ASV19	ITS2 Extracted ITS2 sequence 56-251 (196 bp)	GTTTTTCAACCTACCTATGTTTCTTGCTGGGTGAGGCTTGGATGTGGAGGAAAATATGTGCAGGCCTTTATGACTATGTCATGGGTCGGCTCCTCTGAAATGCATTAGCGGAGCTGCTTGCAACCTTGCTATAGGCGTGATAAATAATTTCTGTGCCAAGTGGGGTTTGCCTTGTTGTGGTTTGGCTTCCAACTCG
ASV20	ITS2 Extracted ITS2 sequence 56-251 (196 bp)	CTCTCTCAAACCCCCGGGTTTGGTATTGAGTGATACTCTTAGTCGAACTAGGCGTTTGCTTGAAAAGTATTGGCATGGGTAGTACTGGATAGTGCTGTCGACCTCTCAATGTATTAGGTTTATCCAACTCGTTGAATGGTGTGGCGGGATATTTCTGGTATTGTTTGCCCGGCCTTACAACAACCAAACAAGTTTG
ASV21	ITS2 Extracted ITS2 sequence 56-251 (196 bp)	GAACTATAACGCACTTGGGGATTGTGCCCAGGAGGCTGTCTTGAAGTGGGGGATGCTTGCCTTTTGTGCTGTCTGTCAGGTAGTCGGCTGTTCCTTTGGGGTCCTGTGTGCACCTGTCTTGGGCTTTAGCATGTTGGGTAGGCTTCTCTGAAATGCATTTGTGAGTGTTGCTTGCGACTTGCTCTGTTGGGTTTAT
ASV22	ITS2 Extracted ITS2 sequence 55-158 (104 bp)	CACCCTCAAACCCCCGGGTTTGGCTGTGAGTGCACGTTTGTCTACTCGAAATTTATGGAACGCATGTCTAGGATTACCCACTCATGTTTTTTCCGGATCTAAAT
ASV23	ITS2 Extracted ITS2 sequence 56-251 (196 bp)	ACATCTCCATAATTAGTTTTTTTTTTAAAATTGATTGTGGGTTTTGAGGTTGTCATATAACAGTGACTCCCTTTAAAATAATTAGTGATGACCTTATGAATGGGTTAATACTGTGTGTTATAATGGATTACATCCATCACCAGTCAGAGAGTAATCTCGCCTTAGTAATTTGTAGTGATTGCTTCTAACTGCCATT
ASV24	ITS2 Extracted ITS2 sequence 56-251 (196 bp)	CTCTCTCAAACCCCCGGGTTTGGTATTGAGTGATACTCTTAGTCGAACTAGGCGTTTGCTTGAAAAGTATTGGCATGGGTAGTACTGGATAGTGCTGTCGACCTCTCAATGTATTAGGTTTATCCAACTCGTTGAATGGTGTGGCGGGATATTTTTGGTATTGTTGGCCCGGCCTTACAACAACCAAACAAGTTTT
ASV25	ITS2 Extracted ITS2 sequence 56-251 (196 bp)	GAACCATAACGCACTTGGGAATTGTGCCCAGGAGGCTGTCTTGAAGTGGGGAATGCTTGCCTTTTGTGCTGTCTGTCAGGTAGTCGGCCGTTCCTTCGGGGTTCTGCGTGCACCTGTCTTGGGCTTTAGCAGGTTGGGTAGGCTTCTCTGAAATGCATTTGTGAGTGTTGCTTGCGACTTGCTCTGTTGGGTTTAT
ASV26	ITS2 Extracted ITS2 sequence 56-251 (196 bp)	CTCTCTCAAACCCCCGGGTTTGGTATTGAGTGATACTCTTAGTCGAACTAGGCGTTTGCTTGAAAAGTATTGGCATGGGTAGTACTGGATAGTGCTGTCGACCTCTCAATGTATTAGGTTTATCCAACTCGTTGAATGGTGTGGCGGGATATTTTTGGTATTTTTTGCCCGGCCTTACAACAACCAAACAAGTTTT
ASV27	ITS2 Extracted ITS2 sequence 56-251 (196 bp)	TACACCCTCACCCCTCCCTCTTTTTGTGGGTCAGTTGGCATATTGCCAGCCTAGGGGTGGATCTGGCTTCCCCAATCTGCCGCTTGGTGGGTTGGGTTGGCTGAAGTACAGAGGCTTAAGCAAGGACCCGATATGGGCTTCAACTGGATAGGTAGCTCCGGCTTGTGCCGACTACACGAAGTTGTGGCTTGTGGAT
ASV28	ITS2 Extracted ITS2 sequence 56-217 (162 bp)	CTGCCCTCAAGCACGGCTTGTGTGTTGGGCCTCCGTCCCCCACCCGGGGGACGGGCCCGAAAGGCAGCGGCGGCACCGTGTCCGGTCCTCGAGCGTATGGGGCTTTGTCACCCGCTCTGTAGGCCCGGCCGGCGCCTGCCGACCCTCATCATCCTTTTTTCA
ASV29	ITS2 Extracted ITS2 sequence 58-251 (194 bp)	ATCGTTGCCCCCCCCCAAACCACCCCTCCCCTCTCGAAAGAGAGAGACGAGGGGACTTGGCCGTGGGCGGATATTGGCCTCCCGTGTGCCGAACGGCCCGCGGTTGGCCTAAATACGAGTTGTCGTCGGCGATGGACGTCGTGGCGTTCGGTGGTCAAATAAACCTCGAGCTCCCGTCGCGCGTACGTCGTCGG
ASV30	ITS2 Extracted ITS2 sequence 56-208 (153 bp)	AACCCTTCAAGCATCGCTTGGTGTTGGGCGCCTGTCCCGCCTCCGCGCGCGGACTCGCCTTGAAAGCATTGGCAGCCTGTGTATTGGCTTCGAGCGCAGCAGATTCGCGCCTCGTCCCCTCTCCGCACAGGCGTCCATTAAGCCACCCCCATA
ASV31	ITS2 Extracted ITS2 sequence 56-251 (196 bp)	CTCTCTCAAACCTTCGGGTTTGGTATTGAGTGATACTCTTAGTCGAACTAGGCGTTTGCTTGAAATGTATTGGCATGAGTGGTACTGGATAGTGCTATATGACTTTCAATGTATTAGGTTTATCCAACTCGTTGAATAGTTTAATGGTATATTTCTCGGTATTCTAGGCTCGGCCTTACAATATAACAAACAAGTT
ASV32	ITS2 Extracted ITS2 sequence 56-251 (196 bp)	AATTCTCAACTCTCTTATACTATTTTGTACAAGAGAGCTTGGATTGTGGAGGCTTGCTGGCACACTTGTTTGTGGTCAGCTCCTCTGAAATGTATTAGCGGAACCGTTTGCGATCTGCCACAAGTGTGATAAACTATCTACACTGACCGGGGGATTGCTCTGTGTTGTTCAGCTACTAATTGTCTCTATTTTGTGA
ASV33	ITS2 Extracted ITS2 sequence 56-213 (158 bp)	GTACCCTCAAGCTTTGCTTGGTGTTGGGCGTCTTGTCTCTAGCTTTGCTGGAGACTCGCCTTAAAGTAATTGGCAGCCGGCCTACTGGTTTCGGAGCGCAGCACAAGTCGCACTCTCTATCAGCAAAGGTCTAGCATCCACTAAGCCTTTTTTTCAAC
ASV34	ITS2 Extracted ITS2 sequence 56-251 (196 bp)	GAACTATAACGCACTTGGGGATTGTGCCCAGGAGGCTGTCTGTCAGGTAGTCGGCTGTTCCCTTGGGGTCCTGTGTGCACCTGTCTTGGGCTTTAGCATGTTGGGTAGGCTTCTCTGAAATGCATTTGTGAGTGTTGCTTGTGACTTGCTCTGTTGGGTTTATAGGCGTCATAGTTTTATGCGCCGGTGAGTCTGC
ASV35	ITS2 Extracted ITS2 sequence 56-203 (148 bp)	CACCACTCAAGCCTCGCTTGGTATTGGGCATCGCGGTCCGCCGCGTGCCTCAAATCGACCGGCTGGGTCTTCTGTCCCCTAAGCGTTGTGGAAACTATTCGCTAAAGGGTGTTCGGGAGGCTACGCCGTAAAACAACCCCATTTCTAA
ASV36	ITS2 Extracted ITS2 sequence 56-223 (168 bp)	TCCTCTCTCAAACCTCCGGGTTTGGTGTTGGACCGCGTTGGCCGCAAGGCCCAACTGGTCTCAAAGACAATGACGGCGTCCCAGGGACCCTCTTCGCACTGAGCTTTCCGGAGCACGCGTAGAGTTTCAAGGGCCCAGGGACCCGGTCGCCTCTAAAAACTTTTTTCA
ASV37	ITS2 Extracted ITS2 sequence 56-251 (196 bp)	GAACCGTAAAGTACCTGGGAGAATTGTGCCTAGAAGGCTGTCTTGAAGTGGAGAGTGCTTGCCTTTTGTATTGTCTGTCAGGTGGTTGGCCATTCCTGTGCATGCCTGTCTTGGGCTTTAGCATGTTGGATAGACTTCTCTGAAATGCATTTGTGAGCATTGCAAGTGACTTGCTTTGTTGGGTTTAATAGGTGTC
ASV38	ITS2 Extracted ITS2 sequence 56-224 (169 bp)	TCCTCTCTCAAACCCCCGGGTTTGGTGTTGGACCGCGTTGGCCTTTCACCGGCCAACTGGTCTCAAAGACAATGACGGCGTCCCAGGGACCCTCTTCGCACTGAGCTTTCCGGAGCACGCGTCGAGTTTCAAGGGCCCAGGGACCCGGTCGCCTCTAAAAACTTTTTCA
ASV39	ITS2 Extracted ITS2 sequence 56-206 (151 bp)	CACCACTCAAGCTATGCTTGGTATTGGGCGTCGTCCTTAGTTGGGCGCGCCTTAAAGACCTCGGCGAGGCCACTCCGGCTTTAGGCGTAGAATTTATTCGAACGTCTGTCAAAGGAGAGGAACTCTGCCGACTGAAACCTTTATTTTTCTA
ASV41	ITS2 Extracted ITS2 sequence 56-251 (196 bp)	GAACCATAATGCACTTGGGAATTGTGCCCAGGAGGCTGTCTTGAAGTGGGGAATGCTTGCCTTTTGTGCTGTCTGTCAGGTAGTCGGCCGTTCCTTCGGGGTTCTGCGTGCACCTGTCTTGGGCTTTAGCATGTTGGGTAGGCTTCTCTGAAATGCATTTGTGAGTGTTGCTTGTGACTTGCTCTGTTGGGTTTAT
ASV42	ITS2 Extracted ITS2 sequence 56-227 (172 bp)	CTGCCCTCCAGCACGGCTGGGTGTTGGGCGCTGTCCCCCCGGGGACACGCCCCAAAAGCAGTGGCGGCGCCGCGTCGGGTCCTCGAGCGTATGGGGCTCTGTCACCCGCTCGGGAGGGACTCGGTCGGCGCTGGTCTTCCCTTTAGGCCGCCCTTCGGGGTGCGCCTCTTCC
