ASV1	ITS2 Extracted ITS2 sequence 56-251 (196 bp)	GAACTATAACGCACTTGGGGATTGTGCCCAGGAGGCTGTCTTGAAGTGGGGAATGCTTGCCTTTTGTGCTGTCTGTCAGGTAGTCGGCTGTTCCTTTGGGGTCCTGTGTGCACCTGTCTTGGGCTTTAGCATGTTGGGTAGGCTTCTCTGAAATGCATTTGTGAGTGTTGCTTGCGACTTGCTCTGTTGGGTTTAT
ASV2	ITS2 Extracted ITS2 sequence 56-251 (196 bp)	GAACTATAACGCACTTGGGGATTGTGCCCAGGAGGCTGTCTTGAAGTGGGGGATGCTTGCCTTTTGTGCTGTCTGTCAGGTAGTCGGCTGTTCCTTTGGGGTCCTGTGTGCACCTGTCTTGGGCTTTAGCATGTTGGGTAGGCTTCTCTGAAATGCATTTGTGAGTGTTGCTTGCGACTTGCTCTGTTGGGTTTAT
ASV3	ITS2 Extracted ITS2 sequence 56-251 (196 bp)	GGAAGGTGACGCTACTTGGGAATTGTGATGATTCCCAGGAAGCTGTCTTGAAGTGGGGAGTGCTTGCCTTTCATGTTATGTGTGTTGTCTGTCAGGTAGTTGAGCCGTTCCTTTTGGGTCCTGTGCGCACACCCTGTCTGGGCTAAAAAAAAAGCATGGTTGGGTAGGCTTCTCTGAAATGCATTTGTGAGTGTCA
ASV4	ITS2 Extracted ITS2 sequence 56-251 (196 bp)	GGAAGGTAACGCTACTTGGGAATTGTGATGATTCCCAGGAAGCTGTCTTGAAGTGGGGAGTGCTTGCCTTTCATGTTATGTGTGTTGTCTGTCAGGTAGTTGAGCCGTTCCTTTTGGGTCCTGTGCACACCCTGTCTGGGCTTTTTTAGCATGGTTGGGTAGGCTTCTCTGAAATGCATTTGTGAGTGTCACTTGT
ASV5	ITS2 Extracted ITS2 sequence 56-251 (196 bp)	GAACCATAACGCACTTGGGAATTGTGCCCAGGAGGCTGTCTTGAAGTGGGGAATGCTTGCCTTTTGTGCTGTCTGTCAGGTAGTCGGCCGTTCCTTCGGGGTTCTGCGTGCACCTGTCTTGGGCTTTAGCAGGTTGGGTAGGCTTCTCTGAAATGCATTTGTGAGTGTTGCTTGCGACTTGCTCTGTTGGGTTTAT
ASV6	ITS2 Extracted ITS2 sequence 56-251 (196 bp)	GAACTATAACGCACTTGGGGATTGTGCCCAGGAGTGGGGAATGCTTGCCTTTTGTGCTGTCTGTCAGGTAGTCGGCTGTTCCTTTGGGGTCCTGTGTGCACCTGTCTTGGGCTTTAGCATGTTGGGTAGGCTTCTCTGAAATGCATTTGTGAGTGTTGCTTGTGACTTGCTCTGTTGGGTTTATAGGCGTCATAGT
ASV7	ITS2 Extracted ITS2 sequence 56-251 (196 bp)	GAACTATAACGCACTTGGGAATTGTGCCCAGGAGGCTGTCTTGAAGTGGGGAATGCTTGCCTTTTGTGCTGTCTGTCAGGTAGTCGGCTGTTCCTTTGGGGTCCTGCGTGCACCTGTCTTGGGCTTTAGCATGTTGGGTAGGCTTCTCTGAAATGCATTTGTGAGTGTTGCTTGCGACTTGCTCTGTTGGGTTTAT
ASV8	ITS2 Extracted ITS2 sequence 56-203 (148 bp)	CTCTCTCAAACCCCCGGGTTTGGTATTGAGTGATACTCTTAGTCGGACTAGGCGTTTGCTTGAAAAGTATTGGCATGGGTAGTACTGGATAGTGCTGTCGACCTCTCAATGTATTAGGTTTATCCAACTCGTTGAATGGTGTGGCGGG
ASV9	ITS2 Extracted ITS2 sequence 55-251 (197 bp)	TGAATCGTAACGCACTTGGGAGTTGTTATGATTCCCAGGAGGCTGTCTTGAAGTGGGGAGTGCTTGCCTTTTCATGCCTTTCATGTTTGTCTGTCAGGTAGTTGAGCCGTTCCTTTTGGTTCTGTGCACACCCTGTTGCGGGCCCTGTCTTGCATGTTGTTGGTAGGCTTCTCTGAAATGCATTTGTGAGTGTTGCT
ASV10	ITS2 Extracted ITS2 sequence 56-133 (78 bp)	CAACCCTCGAACCCCTCCGGGGGGTCGGCGTTGGGGATCGGCCCTTTACGGGGCCGGCCCCGAAATACAGTGGCGGTC
ASV11	ITS2 Extracted ITS2 sequence 56-251 (196 bp)	GATCCATAAGGTGGTATATGCCCTGGTTCGGGTCGCTTATGTGTCCTGAGTTAGCTGGGGGGAGCCGTACAATGGGGATTGTTTGCCTTTCGTGTTGTCTGTCAGGTAGTCGGCCGTTCCTTCGGGGTCCAGTGCACACCTGTCTTGGGCTTTAGCACGATGGGTGGGCTTCTCTGAAAAGCATTTGTGGGAGCTG
ASV12	ITS2 Extracted ITS2 sequence 56-251 (196 bp)	GAACTATAACGCACTTGGGGATTGTGCCCAGGAGGCTGTCTTGAAGTGGGGAATGCTTGCCTTTTGTGCTGTCTGTCAGGTAGTCGGCTGTTCCTTTGGGGTCCTGTGTGCACCTGTCTTGGGCTCTAGCATGTTGGGTAGGCTTCTCTGAAATGCATTTGTGAGTGTTGCTTGCGACTTGCTCTGTTGGGTTTAT
ASV13	ITS2 Extracted ITS2 sequence 56-251 (196 bp)	AATCATCGACTCTAAGTGCCTTTGCGCACCTAGTGCTTGGTCTTGAGGGTCTGTGGGCGCTCTGAGCGTCCTGCTCCCTTTAAATCCATTAGCGAGACTTCCCTGTGCTGACCGTCTCTCGGCGTGATAATTATCTGCGTCGGACCGGACGGTTCTCGTTGGGCTTGCTTCTAATCGTCTTCGGACAAATCCGACT
ASV14	ITS2 Extracted ITS2 sequence 56-251 (196 bp)	AATCATCGACTCTAAGTGCCTTTGCGCACCTAGTGCTTGGTCTTGAGGGTCTGTGGGCGCTCTGAGCGTCCTGCTCCCTTTAAATCCATTAGCGAGACTTCCCTGTGCTGACCGTCTCTCGGCGTGATAATTATCTGCGTCGGACCGGACGGTTCTCGTTGGGCTTGCTTCTAATCGTCTTCGGACAAATCCGACT
ASV15	ITS2 Extracted ITS2 sequence 56-251 (196 bp)	GAACTATAACGCACTTGGGGATTGTGCCCAGGAGGCTGTCTTGAAGTGGGGAATGCTTGCCTTTTGTGCTGTCTGTCAGGTAGTCGGCCGTTCCTTCGGGGTTCTGCGTGCACCTGTCTTGGGCTTTAGCAGGTTGGGTAGGCTTCTCTGAAATGCATTTGTGAGTGTTGCTTGCGACTTGCTCTGTTGGGTTTAT
ASV16	ITS2 Extracted ITS2 sequence 56-132 (77 bp)	CAACCCTCGAACCCCTCCGGGGGGTCGGCGTTGGGGATCGGCCCTTTACGGGGCCGGCCCCGAAATACAGTGGCGGT
ASV17	ITS2 Extracted ITS2 sequence 56-145 (90 bp)	CAACCCTCGAACCCCTCCGGGGGGTCGGCGTTGGGGATCGGGAACCCCTAAGACGGGATCCCGGCCCCGAAATACAGTGGCGGTCTCGCC
ASV18	ITS2 Extracted ITS2 sequence 56-145 (90 bp)	CAACCCTCGAACCCCTCCGGGGGGTCGGCGTTGGGGATCGGCCCTCCCTTAGCGGGGTGGCCGTCTCCGAAATACAGTGGCGGTCTCGCC
ASV19	ITS2 Extracted ITS2 sequence 56-251 (196 bp)	GAACTATAACGCACTTGGGGATTGTGCCCAGGAGGCTGTCTTGAAGTGGGGAATGCTTGCCTTTTGTGCTGTCTGTCAGGTAGTCGGCTGTTCCTTTGGGGTCCTGTGTGCACCTGTCTTGGGCTTTAGCATGTTGGGTAGGCTTCTCTGAAATGCATTTGTGAGTGTTGCTTGTGACTTGCTCTGTTGGGTTTAT
ASV20	ITS2 Extracted ITS2 sequence 56-251 (196 bp)	GAACTATAACGCACTTGGGAATTGTGCCCAGGAGGCTGTCTTGAAGTGGGGAATGCTTGCCTTTTGTGCTGTCTGTCAGGTAGTCGGCTGTTCCTTCGGGGTCCTGCGTGCACCTGTCTTGGGCTTTAGCATGTTGGGTAGGCTTCTCTGAAATGCATTTGTGAGTGTTGCTTGCGACTTGCTCTGTTGGGTTTAT
ASV21	ITS2 Extracted ITS2 sequence 56-251 (196 bp)	GGAAGGTAACGCTACTTGGGAATTGTGATGATTCCCAGGAAGCTGTCTTGAAGTGGGGAGTGCTTGCCTTTCATGTTATGTGTGTTGTCTGTCAGGTAGTTGAGCCATTCCTTTTGGGTCCTGTGCACACCCTGTCTGGGCTTTTTTAGCATGGTTGGGTAGGCTTCTCTGAAATGCATTTGTGAGTGTCACTTGT
ASV22	ITS2 Extracted ITS2 sequence 56-183 (128 bp)	CAACCCTCGACTTCCCTTTGGGGAAATCGGCGTTGGGGAACGGCAGCATACCGCCGGCCCCGAAATGAAGTGGCGGCCCGTCCGCGGCGACCTCTGCGTAGTAATCCAACTCGCACCGGAACCCCGAC
ASV23	ITS2 Extracted ITS2 sequence 56-219 (164 bp)	CTGCCCTCAAGCCCGGCTTGTGTGTTGGGCCCCGTCCCCCGATCTCCGGGGGACGGGCCCGAAAGGCAGCGGCGGCACCGCGTCCGGTCCTCGAGCGTATGGGGCTTTGTCACCCGCTCTGTAGGCCCGGCCGGCGCTTGCCGATCAACCCAAATTTTTATCCA
ASV24	ITS2 Extracted ITS2 sequence 56-138 (83 bp)	CAACCCTCGAACCCCTCCGGGGGGTCGGCGTTGGGGATCGGCCCTTTACGGGGCCGGCCCCGAAATACAGTGGCGGTCTCGCC
ASV25	ITS2 Extracted ITS2 sequence 56-251 (196 bp)	GAACCATAACGCACTTGGGAATTGTGCCCAGGAGGCTGTCTTGAAGTGGGGAATGCCTGCCTTTTGTGCTGTCTGTCAGGTAGTCGGCCGTTCCTTCGGGGTTCTGCGTGCACCTGTCTTGGGCTTTAGCAGGTTGGGTAGGCTTCTCTGAAATGCATTTGTGAGTGTTGCTTGCGACTTGCTCTGTTGGGTTTAT
ASV26	ITS2 Extracted ITS2 sequence 55-251 (197 bp)	TGAACCATAACGCACTTGGGAATTGTGCCCAGGAGGCTGTCTTGAAGTGGAGAATGCTTGCCTTTTGTGCTGTCTGTCAGGTAGTCGGCCGTTCCTTCGGGGTTCTGCGTGCACCTGTCTTGGGCTTTAGCAGGTTGGGTAGGCTTCTCTGAAATGCATTTGTGAGTGTTGCTTGCGACTTGCTCTGTTGGGTTTAT
ASV27	ITS2 Extracted ITS2 sequence 56-251 (196 bp)	ACTCTTCAACTCCCCAATTTCTTGTAGATTGTGTGGAAGTTTGGATTTTGAATGTTGCTGGCCCCTTGTGGGCGTAGCTCGTTCGTAATACATTAGCATCTTTAATTCGAACTCGGATTGACTCAGTGTAATAGACTATTCGCTGAGGACACTTTAGTAGCAATACTTTGGTGGCCGTGATCAATACAAGAGAAGC
ASV28	ITS2 Extracted ITS2 sequence 56-251 (196 bp)	GATCCATAAGGTGGTATATGCCCTGGTCCCGGGTCGCTTATGTGTCCTGAGTTAGCTGGGGGGAGCCGTACAATGGGGATTGTTTGCCTTTCGTGTTGTCTGTCAGGTAGTCGGCCGTTCCTTCGGGGTCCAGTGCACACCTGTCTTGGGCTTTAGCACGATGGGTGGGCTTCTCTGAAAAGCATTTGTGGGAGCT
ASV29	ITS2 Extracted ITS2 sequence 56-131 (76 bp)	CAACCCTCAAGCCCCCGGGTTTGGTGTTGGGGATCGGCGAGTCTTAGGACCAGCCGCCCCCTAAATCTAGTGGCGG
ASV30	ITS2 Extracted ITS2 sequence 56-251 (196 bp)	GGAAGGTAACGCTACTTGGGAATTGTGATGATTCCCAGGAAGCTGTCTTGAAGTGGGGAGTGCTTGCCTTTCATGTTATGTGTGTTGTCTGTCAGGTAGTTGAGCCGTTCCTTTTGGGTCCTGTGCACACCCTGTCTGGGCTTTTTTAGCATGGTTGGGTAGGCTTCTCTGAAATGCATTTGTGAGTGTCACTTGT
ASV31	ITS2 Extracted ITS2 sequence 56-203 (148 bp)	CACCACTCAAGCCTCGCTTGGTATTGGGCAACGCGGTCCGCCGCGTGCCTCAAATCGACCGGCTGGGTCTTCTGTCCCCTAAGCGTTGTGGAAACTATTCGCTAAAGGGTGTTCGGGAGGCTACGCCGTAAAACAACCCCATTTCTAA
ASV32	ITS2 Extracted ITS2 sequence 56-251 (196 bp)	GAACCATAATGCACTTGGGAATTGTGCCCAGGAGGCTGTCTTGAAGTGGGGAATGCTTGCCTTTTGTGCTGTCTGTCAGGTAGTCGGCCGTTCCTTCGGGGTTCTGCGTGCACCTGTCTTGGGCTTTAGCAGGTTGGGTAGGCTTCTCTGAAATGCATTTGTGAGTGTTGCTTGCGACTTGCTCTGTTGGGTTTAT
ASV33	ITS2 Extracted ITS2 sequence 56-215 (160 bp)	CAACCCTTAAGCCCTGTTGCTTAGCGTTGGGAGCCTACAGCACCCGCTGTAGCTCCTCAAAGTTAGCGAGCGGAGTCGGCCTCACACTCTGGACGTAGTACATCTCTCTCGTCTATCAGTGGAACCGGTCTCCCGCCGTAAAACACACCAAATTCTTTTA
ASV34	ITS2 Extracted ITS2 sequence 56-250 (195 bp)	GGAAGGTGACGCTACTTGGGAATTGTGATGATTCCCAGGAAGCTGTCTTGAAGTGGGGAGTGCTTGCCTTTCATGTTATGTGTGTTGTCTGTCAGGTAGTTGAGCCGTTCCTTTTGGGTCCTGTGCGCACACCCTGTCTGGGCTAAAAAAAAAGCATGGTTGGGTAGGCTTCTCTGAAATGCATTTGTGAGTGTC
ASV35	ITS2 Extracted ITS2 sequence 55-251 (197 bp)	TGAACCATAACGCACTTGGGAATTGTGCCCAGGAGGCTGTCTTGAAGTGGGGAATGCTTGCCTTTTGTGCTGTCTGTCAGGTAGTCGGCCATTCCTTCGGGGTTCTGCATGCACCTGTCTTGGGCTTTAGCAGGTTGGGTAGGCTTCTCTGAAATGCATTTGTGAGTGTTGCTTGCGACTTGCTCTGTTGGGTTTAT
ASV36	ITS2 Extracted ITS2 sequence 56-215 (160 bp)	CAACCCTCGACTTCCCTTTGGGGAAATCGGCGTTGGGGAACGGCAGCATACCGCCGGCCCCGAAATGAAGTGGCGGCCCGTCCGCGGCGACCTCTGCGTAGTAATCCAACTCGCACCGGAACCCCGACGTGGCCACGCCGTAAAACACCCAACTTCTGAA
ASV37	ITS2 Extracted ITS2 sequence 56-219 (164 bp)	CTGCCCTCAAGCCCGGCTTGTGTGTTGGGCCCCGTCCCCCGATCTCCGGGGGACGGGCCCGAAAGGCAGCGGCGGCACCGCGTCCGGTCCTCGAGCGTATGGGGCTTTGTCACCCGCTCGGTAGGCCCGGCCGGCGCTTGCCGATCAACCCAAATTTTTATCCA
ASV38	ITS2 Extracted ITS2 sequence 56-251 (196 bp)	GGAAGGTAACGCTACTTGGGAATTGTGATGATTCCCAGGAAGCTGTCTTGAAGTGGGGAGTGCTTGCCTTTCATGTTATGTGTGTTGTCTGTCAGGTAGTTGAGCCGTTCCTTTTGGGTCCTGTGCACACCCTGTCTGGGCTAAAAAAGCATGGTTGGGTAGGCTTCTCTGAAATGCATTTGTGAGTGTCACTTGT
ASV39	ITS2 Extracted ITS2 sequence 56-251 (196 bp)	GAACTATAACGCACTTGGGGATTGTGCCCAGGAGGCTGTCTTGAAGTGGGGAATGCTTGCCTTTTGTGCTGTCTGTCAGGTAGTCGGCTGTTCCTTTGGGGTCCTGTGTGCACCTGTCTTGGGCTTTAGCATGTTGGGTAGGCTTCTCTGAAATGCATTTGTGAGTGTCACTTGTGGCTTGCTTTGTAGGTGTCAT
ASV40	ITS2 Extracted ITS2 sequence 56-251 (196 bp)	CATCCTCAAACCTTCTTGGTTTCTTGACTAGGAAGGCTTTGGACTTTGGGGGCTTTTGCTGGCCTTCTCTTGTTGAAGCCAGCTCCTCTGAAATGAATTAGTGGGGTCTGCTTTGCTGATCCTTGACGTGATAAGATGTTTCTACGTCTTGGGTTAGCACTGTTTGCTCTAGATCCTGCTTCTAACTGTCTTATGG
ASV41	ITS2 Extracted ITS2 sequence 56-251 (196 bp)	GAACTATAACGCACTTGGGGATTGTGCCCAGGAGGCTGTCTTGAAGTGGGGAATGCTTGCCTTTTGTGCTGTCTGTCAGGTAGTCGGCTGTTCCTTTGGGGTCCTGTGTGCACCTGTCTTGGGCTTTAGCATGTTGGGTAGGCTTCTCTGAAATGCATTTGTGAGTGTCACTTGTGGTGGCTTGCTTTGTAGGTGT
ASV42	ITS2 Extracted ITS2 sequence 56-132 (77 bp)	CAACCCTCAAGCCCCCGGGTTTGGTGTTGGGGATCGGCGAGTCTTAGGACCAGCCGCCCCCTAAATCTAGTGGCGGT
ASV43	ITS2 Extracted ITS2 sequence 56-183 (128 bp)	CAACCCTCGACTTCCCCTCGGGGAAATCGGCGTTGGGGAACGGCAGCATACCGCCGTCCCCGAAATGGAGTGGCGGCCCGTCCGCGGCGACCTCTGCGTAGTAATCCAACTCGCACCGGAACCCCGAC
ASV44	ITS2 Extracted ITS2 sequence 56-251 (196 bp)	AAACCTCGAACCAAAGTCCTTCGATCCGTCGGAGCTTTGTTTTCGGACCATGGGAGCATGCGGGCGGCGACGTCGGCTCTCCTCAAAAGCATTAGCTGTGGGCGGCGAGCCTTGCGTGACACACGGCCTTGTTCGACGTCGTAATGATCGTCGTGGGCTGGAGGCGCGTGGATCGACCGGTCTCATGCTTCGCAAC
ASV45	ITS2 Extracted ITS2 sequence 56-251 (196 bp)	GATCCATAAGGTGGTATATGCCCTGGTCCCGGGTCGCTTATGTGTCCTGAGTTAGCTGGGGGGAGCCGTACAATGGGGATTGTTTGCCTTTCGTGTTGTCTGTCAGGTAGTCGGCCGTTCCTTCGGGGTCCAGTGCACACCTGTCTTGGGCTTTAGCACGATGGGTGGGCTTCTCTGAAAAGCATTTGTGGAAGCT
ASV46	ITS2 Extracted ITS2 sequence 56-251 (196 bp)	GAACCATAACGCACTTGGGAATTGTGCCCAGGAGGCTGTCTTGAAGTGGGGAATGCTTGCCTTTTGTGCTGTCTGTCAGGTAGTCGGCCGTTCCTTCGGGGTTCTGCGTGCACCTGTCTTGGGCTTTAGCAGGTTGGGTAGGCTTCTCTGAAATGCATTTGTGAGTGTTGCTTGCGACTTGCTCTGTTGGGTTTAT
ASV47	ITS2 Extracted ITS2 sequence 55-251 (197 bp)	TGAATCGTAACGCACTTGGGAGTTGTTATGATTCCCAGGAGGCTGTCTTGAAGTGGGGAGTGCTTGCCTTTTCATGCCTTTCATGTTTGTCTGTCAGGTAGTTGAGCCGTTCCTTTTGGGTCCTGTGCACACCCTGTCTGGGCTTTTTTTAGCATGGTTGGGTAGGCTTCTCTGAAATGCATTTGTGAGTGTCACTT
ASV48	ITS2 Extracted ITS2 sequence 56-221 (166 bp)	CTGCCCTCAAGCCCGGCTTGTGTGTTGGGCCCCGTCCTCCGATTTCCGGGGGACGGGCCCGAAAGGCAGCGGCGGCACCGCGTCCGGTCCTCGAGCGTATGGGGCTTTGTCACCCGCTCTGTAGGCCCGGCCGGCGCTTGCCGATCAACCCAAATTTTTTTATCCA
ASV49	ITS2 Extracted ITS2 sequence 56-251 (196 bp)	AATTCTCAACCTCACCAGTTTTGTAACGAGACAGGTGAAGGCTTGGATGTGGGGGTTTTGCAGGCTGCCTCAGTGCTGGTCTGCTCCCCTGAAATGCATTAGCGAGCTCATATTGAGCTTCCGTCTATTGGTGTGATAATTATCTACGCCGTGGATTGGACTCATGCTTGCTTCTAACCGTCCGCAAGGACAATTT
ASV50	ITS2 Extracted ITS2 sequence 56-251 (196 bp)	TGGTTCTCAATACCATGCTGATTTTATTTGGTGTGGCTTTGGATATTGGGGGGTTTTGCAGGCTTCTGAAAAGTCAGCTCTCCTGAAATGCATTAGTGGTATCTGAGCAGAGACTACTTACAGGTGTGATAATCATATATCTATGCCTTGGTACGCTGCATAAAACAGATTGCACTGCTTACAACGAGTAGGAATT
ASV51	ITS2 Extracted ITS2 sequence 56-251 (196 bp)	GAACCATAATGCACTTGGGAATTGTGCCCAGGAGGCTGTCTTGAAGTGGGGAATGCTTGCCTTTTGTGCTGTCTGTCAGGTAGTCGGCCGTTCCTTCGGGGTTCTGCGTGCACCTGTCTTGGGCTTTAGCAGGTTGGGTAGGCTTCTCTGAAATGCATTTGTGAGTGTTGCTTGCGACTTGCTCTGTTGGGTTTAT
ASV52	ITS2 Extracted ITS2 sequence 56-251 (196 bp)	GAACCATAACGCACTTGGGAATTGTGCCCAGGAGGCTGTCTTGAAGTGGGGAATGCTTGCCTTTTGTGCTGTCTGTCAGGTAGTCAGCCGTTCCTTCGGGGTTCTGCGTGCACCTGTCTTGGGCTTTAGCAGGTTGGGTAGGCTTCTCTGAAATGCATTTGTGAGTGTTGCTTGCGACTTGCTCTGTTGGGTTTAT
ASV53	ITS2 Extracted ITS2 sequence 56-251 (196 bp)	GAACCATAATGCACTTGGGAATTGTGCCCAGGAGGCTGTCTTGAAGTGGGGAATGCTTGCCTTTTGTGCTGTCTGTCAGGTAGTCGGCTGTTCCTTCGGGGTTCTGCGTGCACCTGTCTTGGGCTTTAGCAGGTTGGGTAGGCTTCTCTGAAATGCATTTGTGAGTGTTGCTTGCGACTTGCTCTGTTGGGTTTAT
ASV54	ITS2 Extracted ITS2 sequence 56-251 (196 bp)	GAACTATAACGCACTTGGGGATTGTGCCCAGGAGGCTGTCTTGAAGTGGGGGATGCTTGCCTTTTGTGCTGTCTGTCAGGTAGTCGGCTGTTCCTTTGGGGTCCTGTGTGCACCTGTCTTGGGCTTTAGCATGTTGGGTAGGCTTCTCTGAAATGCATTTGTGAGTGTCACTTGTGGCTTGCTTTGTAGGTGTCAT
ASV55	ITS2 Extracted ITS2 sequence 58-251 (194 bp)	GTCGTTGCCCCCCCCAAACCCCTAGGGAGTTGGGCGGGACGGATGATGGCCTCCCGTGTGCTCTGTCATGCGGTTGGCATAAAAACAAGTCCTCGGCGACTAACGCCACGACAATCGGTGGTTGTCAAACCTCTGTTGCCTATCGTGTGCGCGTGTCGAGCGAGGGCTCCACAAGCCATGTTGCATCGATTCGT
ASV56	ITS2 Extracted ITS2 sequence 56-250 (195 bp)	CCTTCTCAAACACATGTGTTTGGTGGTGAGTGATACTCTTTACTGGGTTAACTTGAAATTGTAGGCCGCAGGGCAGTTGGCAAGGATCCATTGGGTAGTGTACGCTATCCAAGCTTGCTCGATACGAACTTTGTATTAGGTTTTACCGACTCTTAGGACGTGTTGAGACTGAGTAGTGGTCTTTTTGACAACGGT
ASV57	ITS2 Extracted ITS2 sequence 56-143 (88 bp)	CAACCCTCATGCCCCTAGGGCGTGGTGTTGGGGATCGGCCAAAGCCCGCGAGGGACGGCCGGCCCCTAAATCTAGTGGCGGACCCGTC
ASV58	ITS2 Extracted ITS2 sequence 56-251 (196 bp)	ATTTCTCAACCCCTCTCGATTAGCTTCGAGGGGGAGCTTGGATAGTGGGGGTTTGCAGGAAACTTGGACTTTTAGTCTAGGATTCGAGCTCTCCTGAAATACATTGGCTTGCGGTTGACTTTCGACTTTGCGCGATAAGGCTTTCGGCGTGATAATGATCGCCGTGTGCTGAAGCGCATGACTGTGAAGTTCCGTG
ASV59	ITS2 Extracted ITS2 sequence 56-218 (163 bp)	CACCACTCAAGCATAGCTTGGTATTGGGCAACCGCCCCCGCCAGTCGGGGACGCGCCTCAAACACCTCGGCGGAGCCTCACCGGCTTTGGGCGTAGTAGAATTTCTAATAACGTCCTTTAACGGAGATGGTTCCTTTGCCGATAGAATCTTTAAATTTTTCTA
ASV60	ITS2 Extracted ITS2 sequence 56-251 (196 bp)	AATCATCAAAAACCCTTTTCTTTAAAGGATTTTTGGACTTGGAGGTTCCATGCTTGCTTTCGCTCTTGAAAGCGAGCTCCTCTCAAATGAATTAGTGGGGTCCGCTTTGCTGATCCTTGACGTGATAAGATGTTTCTACGTTTTGGATTTAGCACTGTCCGTTGGACGCCTGCTCCTAATCGTCTCTTGGGACATT
ASV61	ITS2 Extracted ITS2 sequence 56-183 (128 bp)	CAACCCTCGACTTCCCTTTGGGGAAATCGGCGTTGGGGACCGGCCGTATACCGCCGGCCCCGAAATGAAGTGGCGGCCCGTCCGCGGCGACCTCTGCGTAGTAATCCAACTCGCACCGGAACCCCGAC
ASV62	ITS2 Extracted ITS2 sequence 56-250 (195 bp)	GGAAGGTGACGCTACTTGGGAATTGTGATGATTCCCAGGAAGCTGTCTTGAAGTGGGGAGTGCTTGCCTTTCATGTTATGTGTGTTGTCTGTCAGGTAGTTGAGCCGTTCCTTTTGGGTCCTGGGCTAAAAAAAAAAGCATGGTTGGGTAGGCTTCTCTGAAATGCATTTGTGAGTGTCACTTGTGGCTTGCTTT
ASV63	ITS2 Extracted ITS2 sequence 56-251 (196 bp)	AATTCTCAACCCCTCTCGATTTTTTTCGAGGGGGAGCTTGGATGGTGGGGGCTGCCGGAGACTAGGACCTCGTCCTTGACTCGGGCTCTCCTTAAATGCATTGGCTTGCGGTCGACTTTCGACTTTGCGCGACAAGGCTTTCGGCGTGATAATGATCGCCGTTTGCTGAAGCGCATGAACGAACGTTCCGTGCCTC
ASV64	ITS2 Extracted ITS2 sequence 56-251 (196 bp)	GGAAGGTAACGCTACTTGGGAATTGTGATGATTCCCAGGAAGCTGTCTTGAAGTGGGGAGTGCTTGCCTTTCATGTTATGTGTGTTGTCTGTCAGGTAGTTGAGCCGTTCCTTTTGGGTCCTGTGCACACCCTGTCTGGGCTTTTTTTAGCATGGTTGGGTAGGCTTCTCTGAAATGCATTTGTGAGTGTTGCTCG
ASV65	ITS2 Extracted ITS2 sequence 56-132 (77 bp)	CAACCCTCGAACCCCTCCGGGGGGTCGGCGTTGGGGATCGGCCCCTCACCGGGCCGCCCCCGAAATACAGTGGCGGT
ASV66	ITS2 Extracted ITS2 sequence 56-250 (195 bp)	AATTCTCAACTCCCTTATGCTGTTTGGTATAGGAGGAGCTTGGATTGTGGAGGCTTGCTGGCCACTTGTCTGAGGTCAGCTCCTCTGAAATGCATTAGCGGAACCGTTTGCGATCTGCCACAAGTGTGATAATTTATCTGCACTGGCAAGGGGGATTGCTCTCTGTGATGTTCAGCTTCTAACTGTCTCTTGATG
ASV67	ITS2 Extracted ITS2 sequence 56-251 (196 bp)	GAACCATAACGCACTTGGGAATTGTGCCCAGGAGGCTGTCTTGAAGTGGGGAATGCTTGCCTTTTGTGCTGTCTGTCAGGTAGTCGGCCATTCCTTCGGGGTTCTGCATGCACCTGTCTTGGGCTTTAGCAGGTTGGGTAGGCTTCTCTGAAATGCATTTGTGAGTGTTGCTTGCGACTTGCTCTGTTGGGTTTAT
ASV68	ITS2 Extracted ITS2 sequence 56-210 (155 bp)	GGAAGGTGACGCTACTTGGGAATTGTGATGATTCCCAGGAAGCTGTCTTGAAGTGGGGAGTGCTTGCCTTTCATGTTATGTGTGTTGTCTGTCAGGTAGTTGAGCCGTTCCTTTTGGGTCCTGTGCGCACACCCTGTCTGGGCTAAAAAAAAAAA
ASV69	ITS2 Extracted ITS2 sequence 56-251 (196 bp)	AATTCTCAACCCCACCAGCTTTTGTGAGCTGGCACTTGGGGCTTGGATGTGGAGGTTTTTGCAGGCCTTGAGTTAGGTCAGCTCCTCTGAAATACATTAGCGGAACCGTTTGCGATCCGTCACAGGTGTGATAATTATCTACGCCAGTGGGTTGCTCTCTTTGTGTTCAGCTGCCAATCGTCCCCCGCAAAGGGAC
ASV70	ITS2 Extracted ITS2 sequence 56-251 (196 bp)	ATCTCTCAACCCCTCTTGATTAGCTTCGAGGGGGAGCTTGGATAGTGGGGGTTTGCAGGAAACTTGGACTTTTTAGTCTAGGATTCGAGCTCTCCTGAAATACATTGGCTTGCGGTCGACTTTCGACTTTGCGCGATAAGGCTTTCGGCGTGATAATGATCGCCGTGTGCTGAAGCGCATGACTGTGAAGTTCCGT
ASV71	ITS2 Extracted ITS2 sequence 56-251 (196 bp)	AATTCTCAACCTCACCCATTTTTGTAATGAAAGTGTGTGTGTAGGCTTGGATGTGGAGGCTTTGCAGGTCCGCCATACCGGTGGTCTGCTCCTCTGAAATGTATTAGTGGGTTGTTCCCCTAATCTATTGGTGTGATAATTATCTACGCCGTGGATCAGGTTGGTAACGATAGACCTGCTTCTAACCGTCCGACTC
ASV72	ITS2 Extracted ITS2 sequence 56-251 (196 bp)	GAACCATAATGCACTTGGGAATTGTGCCCAGGAGGCTGTCTTGAAGTGGGGAATGCTTGCCTTTTGTGCTGTCTGTCAGGTAGTCGGCCGTTCCTTCGGGGTTCTGCATGCACCTGTCTTGGGCTTTAGCAGGTTGGGTAGGCTTCTCTGAAATGCATTTGTGAGTGTTGCTTGCGACTTGCTCTGTTGGGTTTAT
ASV73	ITS2 Extracted ITS2 sequence 56-250 (195 bp)	GATCCATAAGGTGGTATATGCCCTGGTCCCGGGTCGCTTATGTGTCCTGAGTTAGCTGGGGGGAGCCGTACAATGGGGATTGTTTGCCTTTCGTGTTGTCTGTCAGGTAGTCGGCCGTTCCCTTCGGGGTCCAGTGCACACCTGTCTTGGGCTTTAGCACGATGGGTGGGCTTCTCTGAAAAGCATTTGTGGGAG
ASV74	ITS2 Extracted ITS2 sequence 56-131 (76 bp)	CAACCCTCGAACCCCTCCGGGGGGTCGGCGTTGGGGATCGGCCCTTTACGGGGCCGGCCCCGAAATACAGTGGCGG
ASV75	ITS2 Extracted ITS2 sequence 56-133 (78 bp)	CAACCCTCGAACCCCTCCGGGGGGTCGGCGTTGGGGATCGGCCCCTCACCGGGCCGCCCCCGAAATACAGTGGCGGTC
ASV76	ITS2 Extracted ITS2 sequence 56-251 (196 bp)	AATTCTCAACCCCTCTCGATTTTTTTCGAGGGGGAGCTTGGATGGTGGGGGCTGCCGGAGACTAGGACCTCGTCCTTGACTCGGGCTCTCCTTAAATGCATTGGCTTGCGGTCGACTTTCGACTTTGCGCGACAAGGCTTTCGGCGTGATAATGATCGCCGTTCGCTGAAGCGCATGAATGAACGTTCCGTGCCTC
ASV77	ITS2 Extracted ITS2 sequence 56-251 (196 bp)	GAACCATAACGCACTTGGGAATTGTGCCCAGGAGGCTGTCTTGAAGTGGGGAATGCTTGCCTTTTGTGCTGTCTGTCAGGTAGTCGGCCGTTCCTTCGGGGTTCTGCGTGCACCTGTCTTGGGCTTTAGCAGGTTGGGTAGGCTTCTCTGAAATGCATTTGTGAGTGTTGCTTGCAACTTGCTCTGTTGGGTTTAT
ASV79	ITS2 Extracted ITS2 sequence 55-250 (196 bp)	TGAATCGTAACGCACTTGGGAGTTGTTATGATTCCCAGGAGGCTGTCTTGAAGTGGGGAGTGCTTGCCTTTTCATGCCTTTCATGTTTGTCTGTCAGGTAGTTGAGCCGTTCCTTTTGGTTCTGTGCACACCCTGTTGCGGGCCCTGTCTTGCATGTTGTTGGTAGGCTTCTCTGAAATGCATTTGTGAGTGTTGC
ASV80	ITS2 Extracted ITS2 sequence 56-220 (165 bp)	TCCTCCCTCAAACCCCTGGGTTTGGTGTTGGACTCTGTGGTGCGCTGGCACCACTGGTCTCAAAGACAATGACGGCGTCCGTGGGACCCTCGGTGCAACGAGCTTTTCGAAGCACGCGTCGAGTGGACAGTCTCTCCGGGCCGGTCACCTCTCCAATTTTTCTCA
ASV81	ITS2 Extracted ITS2 sequence 56-251 (196 bp)	GGAAGGTGACGCTACTTGGGAATTGTGATAATTCCCAGGAAGCTGTCTTGAAGTGGGGAGTGCTTGCCTTTCATGTTATGTGTGTTGTCTGTCAGGTAGTTGAGCCGTTCCTTTTGGGTCCTGTGCGCACACCCTGTCTGGGCTAAAAAAAAAGCATGGTTGGGTAGGCTTCTCTGAAATGCATTTGTGAGTGTCA
ASV82	ITS2 Extracted ITS2 sequence 55-251 (197 bp)	TGAATCGTAACGCACTTGGGAGTTGTTATGATTCCCAGGAGGCTGTCTTGAAGTGGGGAGTGCTTGCCTTTCATGTTATGTGTGTTGTCTGTCAGGTAGTTGAGCCGTTCCTTTTGGGTCCTGTGCACACCCTGTCTGGGCTTTTTTTAGCATGGTTGGGTAGGCTTCTCTGAAATGCATTTGTGAGTGTCACTTGT
ASV83	ITS2 Extracted ITS2 sequence 55-251 (197 bp)	TGAACCATAACGCACTTGGGAATTGTGCCCAGGAGGCTGTCTTGAAGTGGGGAATGCTTGCCTTTTGTGCTGTCTGTCAGGTAGTCGGCCATTCCTTCGGGGTTCTGCATGCACCTGTCTTGGGCTTTAGCAGGTTGGGTAGGCTTCTCTGAAATGCATTTGTGAGTGTTGCTTGCGACTTGCTCTGTTGGGTTTAT
ASV84	ITS2 Extracted ITS2 sequence 56-209 (154 bp)	GGAAGGTGACGCTACTTGGGAATTGTGATGATTCCCAGGAAGCTGTCTTGAAGTGGGGAGTGCTTGCCTTTCATGTTATGTGTGTTGTCTGTCAGGTAGTTGAGCCGTTCCTTTTGGGTCCTGTGCGCACACCCTGTCTGGGCTAAAAAAAAAA
ASV85	ITS2 Extracted ITS2 sequence 56-127 (72 bp)	CAACCCTCAAGCACAGCTTGGTGTTGGGACTCGCGTTAATTCGCGTTCCTCAAACTGATTGGCGGTCACGTC
ASV86	ITS2 Extracted ITS2 sequence 56-251 (196 bp)	AAATTCTGTCAAAACATGCACCTGTGTGTGTGTTTTGGATTGTGGGAGTGTCTGCTGGTATATATATAATATGAGCCAGCTCTCCTGAAAGATATTAGCTTAGGGGGGATGTGCCAAGTCACTTCTGCCTTTCCCATTGGTGTGATAGATGAATAACTTATCTACGCCAGGAAAGCAGGTTGCAAGTGAAAGCACT
ASV87	ITS2 Extracted ITS2 sequence 56-251 (196 bp)	GAACTATAACGCACTTGGGGATTGTGCCCAGGAGGCTGTCTTGAAGTGGGGGATGCTTGCCTTTTGTGCTGTCTGTCAGGTAGTCGGCTGTTCCTTTGGGGTCCTGTGTGCACCTGTCTTGGGCTTTAGCATGTTGGGTAGGCTTCTCTGAAATGCATTTGTGAGTGTTGCTTGCGACTTGCTCTGTTGGGTTTAT
ASV88	ITS2 Extracted ITS2 sequence 56-251 (196 bp)	GAACTATAACGCACTTGGGGATTGTGCCCAGGAGGCTGTCTTGAAGTGGGGAATGCTTGCCTTTTGTGCTGTCTGTCAGGTAGTCGGCTGTTCCTTTGGGGTCCTGTGTGCACCTGTCCTTGGGCTTTAGCATGTTGGGTAGGCTTCTCTGAAATGCATTTGTGAGTGTCACTTGTGGTGGCTTGCTTTGTAGGTG
ASV89	ITS2 Extracted ITS2 sequence 56-251 (196 bp)	GGAAGGTGACGCTACTTGGGAATTGTGATGATTCCCAGGAAGCTGTCTTGAAGTGGGGAGTGCTTGCCTTTCATGTTATGTGTGTTGTCTGTCAGGTAGTTGAGCCGTTCCTTTTGGGTCCTGTGCGCACACCCTGTCTGGGCTAAGAAAAAAGCATGGTTGGGTAGGCTTCTCTGAAATGCATTTGTGAGTGTCA
ASV90	ITS2 Extracted ITS2 sequence 56-227 (172 bp)	AGGAACGCTCAAGCGAGTTTGCTTGGACTTGGAGGAAGAGCTGTCGCCCTTCGGGGTGGGTTCCCCTCTGAAATTCAATGGCGGATGGTCCGTGCGGACACCGACGTAGTAGGAGCGATCTCTCGTCGCGTCTCTGGATCGTCCTGCCCTCAATCCCCAACAGAGTAATAAT
ASV91	ITS2 Extracted ITS2 sequence 56-251 (196 bp)	AATTCTCAACCCCACCAGCTTTTGTGAGCTGGCACTTGGGGCTTGGATGTGGAGGTTTTTGCAGGCCTTGAGTTAGGTCAGCTCCTCTGAAATACATTAGCGGAACCGTTTGCGATCCGTCACAGGTGTGATAATTATCTACGCCAATGGGTTGCTCTCTTTGTGTTCAGCTGCCAATCGTCCCCCGCAAAGGGAC
ASV92	ITS2 Extracted ITS2 sequence 56-251 (196 bp)	GAACTATAACGCACTTGGGGATTGTGCCCAGGAGGCTGTCTTGAAGTGGGGAATGCTTGCCTTTTGTGCTGTCTGTCAGGTAGTTGGCTGTTCCTTTGGGGTCCTGTGTGCACCTGTCTTGGGCTTTAGCATGTTGGGTAGGCTTCTCTGAAATGCATTTGTGAGTGTTGCTTGCGACTTGCTCTGTTGGGTTTAT
ASV93	ITS2 Extracted ITS2 sequence 56-251 (196 bp)	AATTATCAAAACCCTTTTTCTTTGATCCTTTTTGGAGCGGAAAAGGACTTTTGGACTTGGAGGTTCAATGCTCGCTTTCGCCTTTGAAAGCGAGCTCCCCTCAAATGAATTAGTGGGGTCCGCTTTGCCGATCCTTGACGTGATAAGATGTTTCTACGTTTTGGATTTGGCACTGTCCCTTGGACGTCCGCTCCTA
ASV94	ITS2 Extracted ITS2 sequence 56-250 (195 bp)	TCACCCTTCAAGCCCTGCGCTTGGTGTTGGACGGCTTGGTCGCATATCTCGTTCGACCCCTCCCAAAGACAATGACGGCGGCCCGCGGTTCCCCCGGTACACTGAGCTTTTTAACTGAGCACGTATCGGACAAGGGCGCCCGGGTCACGGTCCTCTCCCGTAACGGGAAACACTTTTAACTAAGGTTGACCTCGG
ASV95	ITS2 Extracted ITS2 sequence 56-250 (195 bp)	TATCCTCGAACCCGAGGGGGTCCGTCCCCCTCTGGGTTCGGAACTTGGGGGCTGCGGGCACGTCCTCGTGGGGACGGTCGGCTCTCCTGAAACGCATCAGCGGAGAGGATGGCATCGCGATGGAGCGTGACCTTTTCCCCTCGACGTCGTAAGGATCGTCGTGGGGCTCGTGATCGCGAGCGATGGACGTCCGTC
ASV96	ITS2 Extracted ITS2 sequence 56-140 (85 bp)	CAACCCTCGAACCCCTCCGGGGGGTCGGCGTTGGGGATCGGCCCTCCCTTAGCGGGGTGGCCGTCTCCGAAATACAGTGGCGGTC
ASV97	ITS2 Extracted ITS2 sequence 56-251 (196 bp)	AATTCTCAACCCCTCTCGATTTTTTTCGAGGGGGAGCTTGGATGGTGGGGGCTGCCGGAGACTAGGACCTCGTCCTTGACTCGGGCTCTCCTTAAATGCATTGGCTTGCGGTCGACTTTCGACTTTGCGCGACAAGGCTTTCGGCGTGATAATGATCGCCGTTCGCTGAAGCGCATGAACGAACGTTCCGTGCCTC
ASV98	ITS2 Extracted ITS2 sequence 56-251 (196 bp)	ACTCTTCAACCTACCGGTTTCTAGTAAATCGGATTAGTGTTTGGATTCTGAACGCCTGCTGGCCTTTATTGGCGAAGCTCGTTCGTAAATGATTAGCATCTCATATTCGAAAATCGGATTGACTCAGTGTAATAGACTATTCGCTGAGGACGCTCTTTCGGGAGTGGCCGAGTTTTGTAAAGTAGAAGCTTCTAAT
ASV99	ITS2 Extracted ITS2 sequence 58-251 (194 bp)	GTCGTTGCCCCCCCCAAACCCCTAGGGAGTTGGGCGGGACGGATGATGGCCTCCCGTGTGCTCTGTCATGTGGTTGGCATAAAAACAAGTCCTCGGCGACTAACGCCACGACAATCGGTGGTTGTCAAACCTCTGTTGCCTATCGTGTGCGGGTGTCGAGCGAGGGCTCCACAAGCCATGTTGCATCGATTCGT
ASV100	ITS2 Extracted ITS2 sequence 56-203 (148 bp)	CACCACTCAAGCCTCGCTTGGTATTGGGCAACGCGGTCCGCCGCGTGCCTCAAATCGACCGGCTGGGTCTTCTGTCCCCTAAGCGTTGTGGAAACTATTCGCTAAAGGGTGTTCGGGAGGCTACGCCGTAAAACAACCCCATTTCTAA
ASV101	ITS2 Extracted ITS2 sequence 56-216 (161 bp)	CAACCCTTAAGCCCCTGTTGCTTAGCGTTGGGAGCCTACGGCACGCGCTGTAGCTTCTTAAAGTTAGTGGGCGGAGTCGGCCTCACACTCCGGACGTAGTACATCTCTCTCGTCCGTCAGGTAAGGCCGGTCTCCCGCCGTAAAACGACCCAATTTCTCAA
ASV102	ITS2 Extracted ITS2 sequence 56-217 (162 bp)	CAACCCTTAAGCCCCCTGTTGCTTAGCGTTGGGAGCCTACAGCGCCCGCTGTAGCTCCTCAAAGTTAGCGAGCGGAGTCGGCCTCACACTCTGGACGTAGTACATCTCTCTCGTCTATCAGTGGAACCGGTCTCCCGCCGTAAAACACACCAAATTCTTTTA
ASV103	ITS2 Extracted ITS2 sequence 56-251 (196 bp)	AATTATCAAAACCCTTTTTCTTTGATCCTTTTTGGAGCGGAAAAGGACTTTTGGACTTGGAGGTTCAATGCTCGCTTTCGCCTTTGAAAGCGAGCTCCTCTCAAATGAATTAGTGGGGTCCGCTTTGCCGATCCTTGACGTGATAAGATGTTTCTACGTTTTGGATTTGGCACTGTCCCTTGGACGTCCGCTCCTA
ASV104	ITS2 Extracted ITS2 sequence 56-208 (153 bp)	TCAACCGTCATGCTTCGGCGTGGAACTGGGGATTGCACAGTTTCCTGCAGCCCTAAATCTCATAAGCGATACCAGTTGGTTCTAAGCGTAGTACATGCCCCGCTACAGGACTTAGCTGGTCTTCGGCTGTAAATGGTGTAAGCCCATACTTAA
ASV105	ITS2 Extracted ITS2 sequence 56-251 (196 bp)	CAACCCTCCGCCGCCCCCCGGGGCGGCGGGCACCTGGGGGACGGCCCGCCCTTTGCCGGCGCGCCGCCCCCGAAATCCAGTGGCGACCGAGCCGCGAACTCCCCTGCGCAGTAGACTTCTTTGCTCGCACCGGAGAGCGGATCGGCCCCGCCGTGAAACCCCCAACTTCTGAAAGTGTGACCTCGGATCAGGTAGG
ASV106	ITS2 Extracted ITS2 sequence 56-251 (196 bp)	AAACCTCGAACCAAAGTCCTTCGATCCGTCGGAGCTTTGTTTTCGGACCATGGGAGCATGCGGGCGGCGACGTCGGCTCTCCTCAAAAGCATTAGCTGTGGGCGGCGAGCCTTGCGTGACACACGGCCTTGTTCGACGTCGTAATGATCGTCGTGGGCTGGAGGCGCGTGGATCGACCGGTCTCATGCTTCGCAAC
ASV107	ITS2 Extracted ITS2 sequence 56-251 (196 bp)	GAACCATAACGCACTTGGGAATTGTGCCCAGGAGGCTGTCTTGAAGTGGGGAATGCTTGCCTTTTGTGCTGTCTGTCAGGTAGTCGGCCGTTCCTTCGGGGTTCTGCGTGCACCTGTCTTGGGCTTTAGCAGGTTGGGTAGGCTTCTCTGAAATGCATTTGTGAGTGTTGCTTGCGACTTGCTCTGTTGGGTTTAT
ASV108	ITS2 Extracted ITS2 sequence 56-251 (196 bp)	ACATCTCAAGACCCTGTCTGCTTTTGATAGGTATTGGATTTTGGGGGTTGCAGGCTGTTTCAGATTGCTTGCTCTCCTTGAATGTATTAGTGGAGAAAATCCATTGAACTCCTTTGGTGTGATAACATCTATCAATGCCAGGAGCAATGTGTCAGTTGTCTCTGCTGTCTAACCTAGCTGTCCATAAACATGGACA
ASV109	ITS2 Extracted ITS2 sequence 56-250 (195 bp)	GGAAGGTAACGCTACTTGGGAATTGTGATGATTCCCAGGAAGCTGTCTTGAAGTGGGGAGTGCTTGCCTTTCATGTTATGTGTGTTGTCTGTCAGGTAGTTGAGCCGTTCCTTTTGGGTCCTGTGCACACCCTGTCTGGGCTTTTTTAGCATGGTTGGGTAGGCTTCTCTGAAATGCATTTGTGAGTGTCACTTG
ASV110	ITS2 Extracted ITS2 sequence 56-251 (196 bp)	AATTCTCAACTCTCTTGTACTATTTTGTACAAGAGAGCTTGGATTGTGGAGGCTTGCTGGCCACTTTGTTGGGGTCAGCTCCTCTAAAATACATTAGCGGAACCGTTTGCGATCTGCCACAAGTGTGATAAACTATCTACACTGACCGGGGGATTGCTCTGTGTTGTTCAGCTACTAATTGTCTTTATTTGATAAG
ASV111	ITS2 Extracted ITS2 sequence 56-208 (153 bp)	CTGCCCTCAAGCACGGCTTGTGTGTTGGGTGCGGTCCCCCCGGGGACCTGCCCGAAAGGCAGCGGCGACGTCCGTCTGGTCCTCGAGCGTATGGGGCTCTGTCACTCGCTCGGGACGGACCTGCGGGGGTTGGTCACCACCATATTTTACCAC
ASV112	ITS2 Extracted ITS2 sequence 56-250 (195 bp)	AAACCTCAACCTCCTTGGTTTCTTTCCGGAGACTGAAGGAGGCTTGGACTTTGGAGGCCTTTGCTGGTGTCTCTCACCAGCTCCTCTTAAATGAATTAGCGGGGTCCTCTTTGCCGATCCTCGACACGTGATAAGATGCTTCCGTGTCTCGGTTTCTGGCTCTGTTGCTTTTGGGACCCGCTTCTAACCGTCTGG
ASV113	ITS2 Extracted ITS2 sequence 56-251 (196 bp)	ACTCTTCAACTCCCCAATTTCTTGTAGATTGTGTGGAAGTTTGGATTTTGAATGTTGCTAGCCCCTTGTGGGCGTAGCTCGTTCGTAATACATTAGCATCTTTAATTCGAACTCGGATTGACTCAGTGTAATAGACTATTCGCTGAGGACACTTTAGTAGCAATACTTTGGTGGCCGTGATCAATACAAGAGAAGC
ASV114	ITS2 Extracted ITS2 sequence 56-251 (196 bp)	CGACCCTCAAGCCCCGGCTTGGTGATGGGCTCCCGCCGCGTGGCGGGCCCGAAACCCGTAGGGCGCCGCGGCAGCGGGCTCTGAGCGTAGCAAGAGCGCAAGCCTCCCTCGCTCCGGAGACCCCTCCACGGCCGCCTGGAGAACACGCACACCGGCGAAGGCTTCCTTCGCCGCGGAAAGGTTGGCCTCGGATCAG
ASV115	ITS2 Extracted ITS2 sequence 56-210 (155 bp)	CTGCCCTCAAGCACGGCTTGTGTGTTGGGTGTGGTCCCCCCGGGGACCTGCCCGAAAGGCAGCGGCGACGCCCGCCTAGGTCCTCGAGCGTATGGGGCTTTGTCACCCGCTCGGGAGGGGCCTTGCGGGCGTTGGTCATCCCTCAATTTTTCCAC
ASV116	ITS2 Extracted ITS2 sequence 56-251 (196 bp)	AATCTTCAACCTAACAAGCTTTGCGGTTTGTTAGGCTTGGACTTGGAGGCTTTGTCGGCCTGACGGTCGGCTCCTCTTAAATGCATTAGCTTGGTTCCTTGCGGATCGGCTCTCGGTGTGATAATTGTCTACGCCGCGACCGTGAAGCGTTTGGCGAGCTTCTAACCGTCTCGCATGAGACAGCTTTATGACCTCT
ASV117	ITS2 Extracted ITS2 sequence 56-250 (195 bp)	AAACCTCAACCTCCTTGGTTTCTTTCTGGAGACTGAAGGAGGCTTGGACTTTGGAGGCCTTTGCTGGTGTCTCTCACCAGCTCCTCTTAAATGAATTAGCGGGGTCCTCTTTGCTGATCCTCGACACGTGATAAGATGCTTCCGTGTCTCGGTTTCTGGCTCTGTTGCTTTTGGGACCCGCTTCTAACCGTCTGG
ASV118	ITS2 Extracted ITS2 sequence 51-134 (84 bp)	GATTTCTTCTCACCGCACCCGGTGGTTTTGCATCCGCGCTAAATATCATTCCAGCAGCGAAGTCTACGCTTTCACTGCTCCATG
ASV119	ITS2 Extracted ITS2 sequence 56-219 (164 bp)	CTGCCCTCAAGCCCGGCTTGTGTGTTGGGCCCCGTCCCCCGATCTCCGGGGGACGGGCCCGAAAGGCAGCGGCGGCACCGCGTCCGGTCCTCGAGCGTATGGGGCTTTGTCACCCGCTCTGTAGGCCCGGCCGGCGCTTGCCGATCAACCCAAATTTTTATCCA
ASV120	ITS2 Extracted ITS2 sequence 57-251 (195 bp)	ACACCTCAACTCTCATGGTTTGCCATGAAGAGCTTGGACTTTGGGGGTTTGCTGGCCGTTCGGTCGGCTCCCCTTAAATGAATCAGCTTGCCAGTGTTTGGTGACGTCGCGGGTGTGATAACTATCTACGCTCACGGTCGCCTGCCAGGTAACCTTTGTCGCCAAAGGTTCGCTGGAGCTTACAAACGTCTCTCC
ASV121	ITS2 Extracted ITS2 sequence 56-250 (195 bp)	AATTCTCAACCTTGTGGCTTTTTACGAGCTAGTGAGGCTTGGATTATGGAGGTTGCTGGTTTTTGCTCACTAGAAACTAGCTCCTCTTAAATGCATTAGCAAGAACCTTTGCTGATCATCTTTCGGTATGATAATTATCTATACCAGTAGAGTGAATCGGTGTCCTTTCATTAGGACGGTTTTGCTTATAATAGT
ASV122	ITS2 Extracted ITS2 sequence 56-251 (196 bp)	GGAAGGTAACACTACTTGGGAATTGTGATGATTCCCAGGAAGCTGTCTTGAAGTGGGGAGTGCTTGCCTTTCATGTTATGTGTGTTGTCTGTCAGGTAGTTGAGCCGTTCCTTTTGGGTCCTGTGCACACCCTGTCTGGGCTTTTTTAGCATGGTTGGGTAGGCTTCTCTGAAATGCATTTGTGAGTGTCACTTGT
ASV123	ITS2 Extracted ITS2 sequence 56-251 (196 bp)	GAACTATAACGCACTTGGGGATTGTGCCCAGGAGGCTGTCTTGAAGTGGGGGATGCTTGCCTTTTGTGCTGTCTGTCAGGTAGTCGGCTGTTCCTTTGGGGTCCTGTGTGCACCTGTCTTGGGCTTTAGCATGTTGGGTAGGCTTCTCTGAAATGCATTTGTGAGTGTTGCTTGCGACTTGCTCTGTTGGGTTTAT
ASV124	ITS2 Extracted ITS2 sequence 56-250 (195 bp)	TCACCCCTCAAGCCCCTGTGCTTGGTGTTGGACGGCTTCGGTCGAGTAACGTCGACCCCTCCTAAAGACAATGACGGCGGCCTGTGGAACCCCCGGTACACTGAGCTTTTAACCGAGCACGTATCGGATGAGGGTGCCCGGGACACGGTCCTTCCTCCCTTCAGTGGGAAAGTTTTCTAAGGTTGACCTCGGATC
ASV125	ITS2 Extracted ITS2 sequence 55-251 (197 bp)	TGAATCGTAACGCACTTGGGAGTTGTTATGATTCCCAGGAAGCTGTCTTGAAGTGGGGAGTGCTTGCCTTTCATGTTATGTGTGTTGTCTGTCAGGTAGTTGAGCCGTTCCTTTTGGGTCCTGTGCACACCCTGTCTGGGCTTTTTTTAGCATGGTTGGGTAGGCTTCTCTGAAATGCATTTGTGAGTGTCACTTGT
ASV126	ITS2 Extracted ITS2 sequence 56-251 (196 bp)	ATCTCTCAACCCCTCTTGATTAGCTTCGAGGGGGAGCTTGGATAGTGGGGGTTTGCAGGAAACTTGGACTTTTCATAGTCTAGGATTCGAGCTCTCCTGAAATACATTGGCTTGCGGTCGACTTTCGACTTTGCGCGATAAGGCTTTCGGCGTGATAATGATCGCCGTGTGCTGAAGCGCATGACTGTGAAGTTCC
ASV127	ITS2 Extracted ITS2 sequence 56-251 (196 bp)	GAACTATAACGCACTTGGGGATTGTGCCCAGGAGGCTGTCTTGAAGTGGGGAATGCTTGCCTTTTGTGCTGTCTGTCAGGTAGTCGGCCGTTCCTTCGGGGTCCAGTGCACACCTGTCTTGGGCTTTAGCACGATGGGTGGGCTTCTCTGAAAAGCATTTGTGGGAGCTGCAAGTGACTTGTTTGTTGGGCTATAG
ASV128	ITS2 Extracted ITS2 sequence 56-251 (196 bp)	GAACCATAACGCACTTGGGAATTGTGCCCAGGAGGCTGTCTTGAAGTGGGGAATGCTTGCCTTTTGTGCTGTCTGTCAGGTAGTCGGCCATTCCTTCGGGGTTCTGCATGCACCTGTCTTGGGCTTTAGCAGGTTGGGTAGGCTTCTCTGAAATGCATTTGTGAGTGTTGCTTGCGACTTGCTCTGTTGGGTTTAT
ASV129	ITS2 Extracted ITS2 sequence 56-251 (196 bp)	ACTCTTCAACTCCCCAATTTCTTGTAGATTGTGTGGAAGTTTGGATTTTGAATGTTGCTGGCCCCTTGTGGGCGTAGCTCGTTCGTAATACATTAGCATCTTTAATTCGAACTCGCATTGACTCAGTGTAATAGACTATTCGCTGAGGACACTTTAGTAGCAATACTTTGGTGGCCGTGATCAATACAAGAGAAGC
ASV130	ITS2 Extracted ITS2 sequence 56-212 (157 bp)	TCACCGTATCAAGCTTGGCTTGTTGTTGGGCCCTTTGTCACCGGGTGACAGGTCCGAAAGACAATGACTGGTGTCATAGAGACTCCCTATGCAACGAGCTTATAACAGCACGCATCTGGTGGTTATGTGACCCGGTTTGCACCCCTTTCTTTCTCAA
ASV131	ITS2 Extracted ITS2 sequence 56-251 (196 bp)	AATCTCAACCACTAGGGTTTCCTAATGGATTGGATTTGGGCGTCTGCGATTTCTGATCGCTCGCCTTAAAAGAGTTAGCAAGTTTGACATTAATGTCTGGTGTAATAAGTTTCACTGGGTCCATTGTGTTGAAGCGTGCTTCTAATCGTCCGCAAGGACAATTACTTTGACTCTGGCCTGAAATCAGGTAGGACTA
ASV132	ITS2 Extracted ITS2 sequence 56-129 (74 bp)	CAACCCTCAAGCTCTGCTTGGTGTTGGGGCCCTACAGCTGATGTAGGCCCTCAAAGGTAGTGGCGGACCCTCCC
ASV133	ITS2 Extracted ITS2 sequence 56-213 (158 bp)	CAACCCTCAAGCCTGGCTTGGTGATGGGGCACTGCTTTCGTCCAGAAAGCAGGCCCTGAAATCTAGTGGCGAGCTCGCCAGGACCCCGAGCGTAGTAGTTATATCTCGCTCTGGAAGGCCCTGGCGGTGCCCTGCCGTTAAACCCCCAACTTCTGAAA
ASV134	ITS2 Extracted ITS2 sequence 56-251 (196 bp)	CAAACCCTCTATCCAACTTTTGTTGAATAGGATGACTGAGAGTCTCTTGATCTTTCGATCTCGAACCTCTTGAAATGTACAAAGGCCTGATCTTGTTTGAATGCCTGAACTTTTTTTTAATATAAAGAGAAGCTCTTGCGATAAACTGTGCTGGGGCCTCCCAAATAACACTCTTTTAAATTTGATCTGAAATCAG
ASV135	ITS2 Extracted ITS2 sequence 56-221 (166 bp)	AATCTCAACCATTAGGGTTTCTTAATGGCTTGGATTTGGAGGTTGCCATTCTGAATGGCTCCTCTTAAAAGAGTTAGCGAGTTTAACTATTGCTATCTGGCGTAATAAGTTTCGCTGGAATGGTATTGTGAAGCGCGCTTCTAATCGTCTTCGGACAATTTTTTGA
ASV136	ITS2 Extracted ITS2 sequence 61-187 (127 bp)	TCGAATCCCCCGGACTTTCCGGGATTCGGAACTTGGGAGTTGCGGGCGTCCGACCCTCGGACGTCGGCTCTCCTCGAACACATCAGCAAGGGAAGGGGCCACGGCACGGCGGCGTGCGACCTCGTCC
ASV137	ITS2 Extracted ITS2 sequence 56-209 (154 bp)	TCACTAATCAAGCCCGGCTTGCTGTTGGACCTCTTGTCGTCAAAAGACAGGCCCCAAAGATAATGACGGTGTTATTGGAACCCTAGATGCAACGAGCTTTAACCAGCACGCATGATAGTGGCTTTTTAACCCGGTCTTTTTTAACCATTTTTAA
ASV138	ITS2 Extracted ITS2 sequence 56-251 (196 bp)	GGATCCATAACGCCACCCAGGTGGCGGCTCTAAGTGGGGAATGCTGGCCTTTTTTTCCTGCTGTCCGTCGGGGTAGTCGGCCGTTCCCTCGAGGTTCTGTGCACACCACGTTCTGGGCTCGTAGCAAGTTGGGGGTTGGCTTTCCTGAAATGCATTTGTGAGAAGTCCGCTTGTCACTCGTTGGGTGTCATAGCCC
ASV139	ITS2 Extracted ITS2 sequence 56-209 (154 bp)	CACCACTCAAGCTATGCTTGGTATTGGGCGTCGTCCTTAGTTGGGCGCGCCTTAAAGACCTCGGCGAGGCCACTCCGGCTTTAGGCGTAGTAGAATTTATTCGAACGTCTGTCAAAGGAGAGGAACTCTGCCGACTGAAACCTTTATTTTTCTA
ASV140	ITS2 Extracted ITS2 sequence 56-199 (144 bp)	CACCATTCAAGCCTGGCTTGGTGTTGGGCGACGTCCCCTTTAGGGACGCGCTTTGAAACGCTCGGCGGCGTGGCACCGGCTTTAAGCGTAGCAGAATCTTTCGCTTTGAAAGTCGGGGCCCCGTCTGCCGGAAGACCTACTCAA
ASV141	ITS2 Extracted ITS2 sequence 58-251 (194 bp)	ATCGTTACCCCCCCACACACACCTGAGTGTGCAACGGGGTGAAAGCTGACTTCCCGCGAGCCAGCTCCTCGTGGTTGGTTGAAAAGTAAGTTCACGGCGGAGTTCGCCGCGATAAATGGTGGATGAGCGATGCTCGAGACCAATCGTGCCTGTGCGACTCCGACGCATCGAACTTGTTGACCCTGTGCGTCCTC
ASV142	ITS2 Extracted ITS2 sequence 56-251 (196 bp)	TAATCTCACTCCGACAGCTTTATTGTTGTCTGGAGGTGGACTTGGGCCTTGCCGTGTCACAACGGCTGGTCTGAAATGCATGAGTGCACCCTGCTGTAGCAGCGTCTTCAGTGTGATAAGTATCTTCACTGATTCAAGTTCCCTCGGGACACGCTCGTCTGGTGGGCTCTGGGCTTCTAACCGTCCGCATGGACAA
ASV143	ITS2 Extracted ITS2 sequence 56-251 (196 bp)	ACATCCTTCAACCTTTCTTGGTTTCTTGACCGGGGAAGGCTTGGACTTTGGGGGTTTTTCATTGCTGGCCTCCCTTGAAGCCAGCTCCTCCTAAATGGATTAGTGGGGTCTGCTTTGCCGATCCTTGACGTGATAAGATGTTTCTACGTCTTGGGTTTCGCACTGTCGCTTCAGACCCCGCTTCAAACAGTCTTGC
ASV144	ITS2 Extracted ITS2 sequence 56-250 (195 bp)	GGAAGGTGACGCTACTTGGGAATTGTGATAATTCCCAGGAAGCTGTCTTGAAGTGGGGAGTGCTTGCCTTTCATGTTATGTGTGTTGTCTGTCAGGTAGTTGAGCCGTTCCTTTTGGGTCCTGTGCGCACACCCTGTCTGGGCTAAAAAAAAAGCATGGTTGGGTAGGCTTCTCTGAAATGCATTTGTGAGTGTC
ASV145	ITS2 Extracted ITS2 sequence 56-251 (196 bp)	GAACTATAACGCACTTGGGGATTGTGCCCAGGAGGCTGTCTTGAAGTGGGGAATGCTTGCCTTTTGTGCTGTCTGTCAGGTAGTCGGCTGTTCCTTTGGGGTCCTGTGTGCACCTGTCTTGGGCTTTAGCATGTTGGGTAGGCTTCTCTGAAATGCATTTGTGAGTGTTGCTCGCGGCTTGCTTTGTAGGTGTCAT
ASV146	ITS2 Extracted ITS2 sequence 56-251 (196 bp)	AATTCTCAACCTTTATCAGCTTTTATTGGCTGATTAGGCTTGGATGTGGGAGTTTTGCGGGCTTTTAAGAAGTCGGCTCTCCTTAAATTCATTAGCGGGACCTTTTGGTCATCTCGGCTACTGGTGTGATAATTATCTACGCCTATTGCTGAAAGTGACTTGGTACAGCTTCTAATCGTCTTTGAGACAATTTATA
ASV147	ITS2 Extracted ITS2 sequence 56-251 (196 bp)	AATTCTCAACCTCACCAGTTTTCTGAACTGCGTCGAGGCTTGGATGTGGGGGTTTGTGCAGGCTGCCTCAGCGCGGTCTGCTCCCCTGAAATGCATTAGCGAGTTCATACTGAGCTCCGTCTATTGGTGTGATAATTATCTACGCCGTTGGTCGGGTTCAGACTTGCTTCTAACCGTCCGCAAGGACAACTCTTTG
ASV148	ITS2 Extracted ITS2 sequence 57-251 (195 bp)	ACACCTCAACTCTCGTGGTTCGCCATGATGAGCTTGGACTTTGGAGGCTTTGCTGGCCTGTGGTCGGCTCCTCTCAAACGAATCAGCTTACCGGTGTATTGGTGGCGTCACAGGTGTGATAACTATCTACGCTTGCGGTCGTCTGCCATACAACCTCTGGCATCGTCAGAGGTTTGCCGGGGGCTCATAAATGTC
ASV149	ITS2 Extracted ITS2 sequence 56-251 (196 bp)	GAACCATAACGCACTTGGGAATTGTGCCCAGGAGGCTGTCTTGAAGTGGGGAATGCTTGCCTTTTGTGCTGTCTGTCAGGTAGTCGGCCGTTCCTTCGGGGTCCAGTGCACACCTGTCTTGGGCTTTAGCACGATGGGTGGGCTTCTCTGAAAAGCATTTGTGGGAGCTGCAAGTGACTTGTTTGTTGGGCTATAG
ASV150	ITS2 Extracted ITS2 sequence 56-251 (196 bp)	GATCCATAAGGTGGTATATGCCCTGGTTCGGGTCGCTTATGTGTCCTGAGTTAGCTGGGGGGAGCCGTACAATGGGGATTGTTTGCCTTTCGTGTTGTCTGTCAGGTAGTCGGCCGTTCCTTCGGGGTCCAGTGCACACCTGTCTTGGGCTTTAGCATGTTGGGTAGGCTTCTCTGAAATGCATTTGTGAGTGTTG
ASV151	ITS2 Extracted ITS2 sequence 56-228 (173 bp)	CACCAATCAAGCACCGCTTGGTATTGGGGATGGTCCCGGCCCTCTCGAGGCGCCGGGGCCTCTCCCGAAATGTATCGGCGAGGACCTCCGACCCCCGACGTGTTAGGAAACTCAAGACGTCAGGAGCACCGGTGGACACTCCGCCGTCGACCTCCCCTCGGGGAACTTTCAAA
ASV152	ITS2 Extracted ITS2 sequence 54-251 (198 bp)	ACGGAAGGTAACGCTACTTGGGAATTGTGATGATTCCCAGGAAGCTGTCTTGAAGTGGGGAGTGCTTGCCTTTCATGTTATGTGTGTTGTCTGTCAGGTAGTTGAGCCGTTCCTTTTGGGTCCTGTGCATACCCTGTCTGGGCTTTTTTAGCATGGTTGGGTAGGCTTCTCTGAAATGCATTTGTGAGTGTCACTTGT
ASV153	ITS2 Extracted ITS2 sequence 56-138 (83 bp)	CAACCCTCGAACCCCTCCGGGGGGTCGGCGTTGGGGATCGGGAACCCCTAAGACGGGATCCCGGCCCCGAAATACAGTGGCGG
ASV154	ITS2 Extracted ITS2 sequence 56-199 (144 bp)	CACCACTCAAGCCTGGCTTGGTATTGGAGGTCGCGGTCCGCCGCGCCTCCTAATGTCGCCGGCCGAGTCGTCTGTCTCCGAGCGTTGTGAATCTTCAATTCGCTTTCGAGTACAGGCGGCGCGCGCCGTTAAACCTCTTTTTCA
ASV155	ITS2 Extracted ITS2 sequence 56-209 (154 bp)	CACCACTCAAGCTATGCTTGGTATTGGGCGTCGTCCTTAGTTGGGCGCGCCTTAAAGACCTCGGCGAGGCCTCCCCGGCTTTAGGCGTAGTAGAATTTATTCGAACGTCTGTCAAAGGAGAGGAACTCTGCCGACTGAAACCTTTATTTTTACA
ASV156	ITS2 Extracted ITS2 sequence 56-125 (70 bp)	CAACCATCAAGCTCTGCTTGCGTTGGGGATCCGCGGCTGCCCGCGGTCCCTCAAAAACAGTGGCGGGCTC
ASV157	ITS2 Extracted ITS2 sequence 56-213 (158 bp)	GTACCCTCAAGCTTTGCTTGGTGTTGGGCGTCTTGTCTCTAGCTTTGCTGGAGACTCGCCTTAAAGTAATTGGCAGCCGGCCTACTGGTTTCGGAGCGCAGCACAAGTCGCACTCTCTATCAGCAAAGGTCTAGCATCCATTAAGCCTTTTTTTCAAC
ASV158	ITS2 Extracted ITS2 sequence 56-228 (173 bp)	TCACCCCTCAAGCCCCGTGCTTGGTGTTGGACGGCCTGGCTGGGCGTGCTGCCCGGCCCCTCCTAAAGACAATGACGGCGGTCCGTGGAACCCCCGGTACACTGAGCTTTTTTACCGAGCACGTACCGGAGACAGGGCGCCCGGGCGACGGTCTGAAACCCTTTATTTCTCAA
ASV159	ITS2 Extracted ITS2 sequence 56-140 (85 bp)	CAACCCTCATGCCCCTAGGGCGTGGTGTTGGGGATCGGCCAAAGCCCGCGAGGGACGGCCGGCCCCTAAATCTAGTGGCGGACCC
ASV160	ITS2 Extracted ITS2 sequence 56-251 (196 bp)	GCACTCTCACACCTAACCTTTGGGTTTATGGCGTGGAATTGGAATGCGCCGACTGTCATGGTTGGCCCTTCTAAAATGTAGTTCTTGGCTGTCACCTAATACAGCAGTTTGGCCTAATAGTTTTGGCATTCATTGTCAAATCTTTGGCTAACATTTGCTCCAGGAGTCAGTCTTGATAATACAGAAAACTCATTCA
ASV161	ITS2 Extracted ITS2 sequence 57-251 (195 bp)	ACACCTCAACTCTCGTGGTTCGCCATGATGAGCTTGGACTTTGGAGGCTTTGCTGGCCTGTGGTCGGCTCCTCTCAAACGAATCAGCTTACCGGTGTATTGGTGGCGTCACAGGTGTGATAACTATCTACGCTTGCGGTCGTCTGCCATACAACCTCTGGCATCGTCAGAGGTTTGCCCGGGGCTCATAAATGTC
ASV162	ITS2 Extracted ITS2 sequence 56-251 (196 bp)	AATCTCCCACCCCAAGCGGTTTTTAAATGAAACGGCTTGGCGGATGGGGTCTGGATGGGTGCCTCTGCCTGCGCTACCTAGCACAGGCTCGCCCGAAATGCATGAGCGCCTTGAGACACTTTGCATCCGCCTCTCTGTTTGGGAGGAGGCGGCCAAGCAGTGTTTTTCTCCTGGCATGGCATGATACGTCATTTGC
ASV163	ITS2 Extracted ITS2 sequence 56-250 (195 bp)	CTCTCTCAAATCTTCGGATTTGGTTTTGAGTGATACTCTTAGTCAGACTAAGCGTTTGCTTGAAATGTATTGGCATGAGTGGTACTAGATAGTGCTGAACTGTTTTCAATGTATTAGGTTTATCCAACTCATTGACCAGTAAAGTATTTGTTTATTACACAGGCTCGGCCTTACAACAACAAACAAAGTTTGACC
ASV164	ITS2 Extracted ITS2 sequence 55-251 (197 bp)	TGAACCATAACGCACTTGGGAATTGTGCCCAGGAGGCTGTCTTGAAGTGGGGAATGCTTGCCTTTTGTGCTGTCTGTCAGGTAGTTGGCCATTCCTTCGGGGTTCTGCATGCACCTGTCTTGGGCTTTAGCAGGTTGGGTAGGCTTCTCTGAAATGCATTTGTGAGTATTGCTTGCGACTTGCTCTGTTGGGTTTAT
ASV165	ITS2 Extracted ITS2 sequence 56-127 (72 bp)	CAACCATCAGGCTCTATCTAGGCCTGTGTTGGGGCCCTGCGGCTGCCGCAGCCCCCTAATTGCAGTGGCGGG
ASV166	ITS2 Extracted ITS2 sequence 56-251 (196 bp)	AACTGTCAAGCTAGGATGATTTTTTTTTCTGTCCTTGCTTGGTTTGTTGGGCTTTGCCGTGTCCTTTCACTAGGAACGGGCTGGCCTTAAAAGTATTAGCCCGACTCCAAGTGGTTTATTGGTATTTCTACTCGGCGTGATAATTAGATGACCGCTGGGAAAGTGTTCCTCTTGGAACCGCCAATATTCATCTGGG
ASV167	ITS2 Extracted ITS2 sequence 56-251 (196 bp)	GAACTATAACGCACTTGGGGATTGTGCCCAGGAGTGGGGAATGCTTGCCTTTTGTGCTGTCTGTCAGGTAGTTGAGCCGTTCCTTTTGGGTCCTGTGCACACCCTGTCTGGGCTTTTTTAGCATGGTTGGGTAGGCTTCTCTGAAATGCATTTGTGAGTGTCACTTGTGGCTTGCTTTGTAGGTGTCATATTTATT
ASV168	ITS2 Extracted ITS2 sequence 56-250 (195 bp)	GAATCCTCAACCACATCGGTTGCCCCGGTGTGGCTTGGACCTGGGAGCATCTTTGCAGGTCTTTGCCTGCTCTCCTGAAAAACATTAGCGGCGTCCAAAGCAGGAAACCGTTGGGAGGGTGTGATAAATCATCAACATCCTTGGTTACACTGCAACTGAGACACAGCTCTCTAATCTGTCTGAATTGAAAAGTTT
ASV169	ITS2 Extracted ITS2 sequence 56-251 (196 bp)	AATTTCTCAAGCTTGGATGGCCTTTTTTGTCTATCCTTAGCCTTGGTTGTTGGGCTTTGCCGTGTCCTTTATTGGGACGGCTGGCCTTAAAAGCATCAGCTGATCCTCGTGCGGCATTGGTTCTACTCAGCGTGATAATAGTCTGATCGCTGAGGACATCTTCTGGGATGGCCAGTGCTCATTTGGGTTGCTTATA
ASV170	ITS2 Extracted ITS2 sequence 56-217 (162 bp)	AAATCTCTTCCCATCGGGTTTCCGATGACGAAGGACTTGGGTGCTGCCAGTCTAATGGCTCGCCTCAAAGGACTCAGTGGTTCGGAAGATCGAATCTGGCGTAATAAGTTTCGCTGGCCTAGATCGGACGTCTGCTCATAACCCGTCTTCCGACATTTTTTG
ASV171	ITS2 Extracted ITS2 sequence 57-251 (195 bp)	ACACCTCAACTCTCATGGTTTGCCATGAAGAGCTTGGACTTTGGGGGTTTGCTGGCCGTTCGGTCGGCTCCCCTTAAATGAATCAGCTTGCCAGTGTTTGGTGGCGTCGCGGGTGTGATAACTATCTACGCTCACGGTCGCCTGCCAGGTAACCTTTGTCGCCAAAGGTTTGCTGGAGCTTACAAACGTCTCTCC
ASV172	ITS2 Extracted ITS2 sequence 56-132 (77 bp)	CAACCCTCAAGCCCTCGGGTTTGGTGTTGGGGATCGGCGAGCCCTTGCGGCAAGCCGGCCCCGAAATCTAGTGGCGG
ASV173	ITS2 Extracted ITS2 sequence 56-210 (155 bp)	GTACCTTCAAGCTCTGCTTGGTGTTGGGTGTTTTGTCTCGCCTCCGCGTGTAGACTCGCCTTAAAACAATTGGCAGCCGGCGTATTGATTTCGGAGCGCAGTACATCTCGCGCTTTGCACTCATAACGACGACGTCCAAAAGTACATTTTTACAC
ASV174	ITS2 Extracted ITS2 sequence 56-212 (157 bp)	CAACCCTTAAGCCTAGCTTAGTGTTGGGAGCCTATCCGCAAGGATAGCTCCTCAAATCCAACGGCGGATCTGTGGTATCCTCTGAGCGTAGTAAAACTTTTATCTCGCTTTTGTCAGGTGCCGCAGCTCTCAGCCGCTAAACCCCCCAATTTTTTGT
ASV175	ITS2 Extracted ITS2 sequence 56-251 (196 bp)	GCACTCTCACAACTAATCTTTGTTGGTTAAGATTGTGGAATTGGGATGCGCCAGTTGTTATTGATTGGCCCTCCTAAAATGTAGCTCTTGACTGTGGACTACTACAGTAGTTTGGCCTAATAGTTTTGGCAGTTATATGTCAAATCTTTGGCTACATTTACTTTGGTCCATGCAGTCTTGATATACAGAAAACTCT
ASV176	ITS2 Extracted ITS2 sequence 56-251 (196 bp)	AATTCTCAACTCTCTTATACTATTTTGTAAAGGAGAGCTTGGATTGTGGAGGCTTGCTGGCCCCTTGTTTGAGGTCAGCTCCTCTGAAATGCATTAGCGGAACCGTTTGCGATCTGCCACAAGTGTGATAAATTATCTACACTAGCCGGGGGATTGCTCTCTGTATTGTTCAGCTACTAATCGTCTCCACTCTGTG
ASV177	ITS2 Extracted ITS2 sequence 55-251 (197 bp)	TGAACCATAACGCACTTGGGAATTGTGCCCAGGAGGCTGTCTTGAAGTGGGGAATGCTTGCCTTTTGTGCTGTCTGTCAGGTAGTCGGCCATTCCTTCGAGGTTCTGCATGCACCTGTCTTGGGCTTTAGCAGGTTGGGTAGGCTTCTCTGAAATGCATTTGTGAGTGTTGCTTGCGACTTGCTCTGTTGGGTTTAT
ASV178	ITS2 Extracted ITS2 sequence 56-204 (149 bp)	CTGCCCTCAAGCCCGGCTTGTGTGTTGGGCCCCGTCCCCCGATCTCCGGGGGACGGGCCCGAAAGGCAGCGGCGGCACCGCGTCCGGTCCTCGAGCGTATGGGGCTTTGTCACCCGCTCTGTTGGCCCGGCCTTACAACAACCAAACAA
ASV179	ITS2 Extracted ITS2 sequence 56-251 (196 bp)	AATTCTCAACCTTTATCAGCTTTTATTGGCTGGATTAGGCTTGGATGTGGGAGTTTTGCGGGCTTTTAAGAAGTCGGCTCTCCTTAAATTCATTAGCGGGACCTTTTGGTCATCTCGGCTACTGGTGTGATAATTATCTACGCCTATTGCTGAAAGTGACTTGGTACAGCTTCTAATCGTCTTTGAGACAATTTAT
ASV180	ITS2 Extracted ITS2 sequence 56-138 (83 bp)	CACCACTCAAGCACAGCTTGGTATTGGGCACCCGTCCGCCTCACGGCGGGCGTGCCTCGAAGACCTCGGCGTGGCCTTTCCGG
ASV181	ITS2 Extracted ITS2 sequence 56-251 (196 bp)	AATTCTCAACCCCTCTCGATTTTTTTTTCGAGGGGGAGCTTGGATGGTGGGGGCTGCCGGAGACTAGGACCTCGTCCTTGACTCGGGCTCTCCTTAAATGCATTGGCTCGCGGTCGACTTTCGACTTTGCGCGACAAGGCTTTCGGCGTGATAATGATCGCCGTTCGCTGAAGCGCATGAATGAACGTTCCGTGCC
ASV182	ITS2 Extracted ITS2 sequence 56-251 (196 bp)	CCTTCTCAAACCTTAGGGTTTGGTAGTGAGTGATACTCTTTCTAGGGTTAACTTGAAAATGCTGGCCATCTGGCTGTTGCTGGCTGAGGCTTTAGTCCAGTCTGCTGATACTCTGCGTATTAGGTTTTACCAACTCGTGGGGGCTTGAGCGGACGCTACAAAGACTTTTGCTAAAAGTACAGACAACCTGGCGAAC
ASV183	ITS2 Extracted ITS2 sequence 56-197 (142 bp)	CAACCCTCAAGCCTAGCTTGGTGTTGGGCCCTGCCCTAAGCGGCCGGCCCTAAAGTCAGTGGCGGCGCCGTCTGGCTCTAAGCGTAGTACATCTCTCGCTCCAGGGTCCTACGGTGGCTTGCCAGAACCCCCCAACTCCTAT
ASV184	ITS2 Extracted ITS2 sequence 56-251 (196 bp)	TAATCTCACTCCGACAACTTTATTGTTGTCTGGAGGTGGACTTGGACCTTGCCGTGTCACAACGGCTGGTCTGAAATGGATGAGTGCACCCTGCTGTAGCAGCGTCTTCAGTGTGATAAGTATCTTCACTGATTCAAGTTCCCTCGGGACACGCTTGTCTGGTGGGCTCTGGGCTTCTAACCGTCCGCATGGACAA
ASV185	ITS2 Extracted ITS2 sequence 56-209 (154 bp)	CACCACTCAAGCTATGCTTGGTATTGGGTGTCGTCCTTAGTTGGGCGCGCCTTAAAGACCTCGGCGAGGCCTCACCGGCTTTAGGCGTAGTAGAATTTATTCGAACGTCTGTCAAAGGAGAGGAACTCTGCCGACCGAAACCTTTATTTTTCTA
ASV186	ITS2 Extracted ITS2 sequence 55-251 (197 bp)	TGAACCATAACGCACTTGGGAATTGTGCCCAGGAGGCTGTCTTGAAGTGGAGAATGCTTGCCTTTTGTGCTGTCTGTCAGGTAGTCGGCCGTTCCTTTGGGGTTCTGCGTGCACCTGTCTTGGGCTTTAGCAGGTTGGGTAGGCTTCTCTGAAATGCATTTGTGAGTGTTGCTTGCGACTTGCTCTGTTGGGTTTAT
ASV187	ITS2 Extracted ITS2 sequence 56-130 (75 bp)	CACCACTCAAGCACTGCTTGGTATTGGGCATCGTCCGTCGAAAGACGGGCGTGCCTCGAAGACCTCGGCGGGGCC
ASV188	ITS2 Extracted ITS2 sequence 56-251 (196 bp)	CCTTCTCAAACACTCGTGTTTGGTTGTGAGTGACACTCTTTCTCTGAGTTAGCTTGAAATTGCTAGCCATAGCGCGAAACACCGCTGGAACTGTATGTGTATCAAGCACATGCTAGTATTTTAGTCGTACTAGGTTTTACCAACTGCGGCGCTGTACTGGTGTGACTTACTGTTTGGTGCATTAGTCTCTTCTGTG
ASV189	ITS2 Extracted ITS2 sequence 56-251 (196 bp)	GAACCATAACGCACTTGGGAATTGTGCCCAGGAGGCTGTCTTGAAGTGGGGAATGCTTGCCTTTTGTGCTGTCTGTCAGGTAGTCGGCCGTTCCTTCGGGGTTCTGCATGCACCTGTCTTGGGCTTTAGCAGGTTGGGTAGGCTTCTCTGAAATGCATTTGTGAGTGTTGCTTGTGACTTGCTCTGTTGGGTTTAT
ASV190	ITS2 Extracted ITS2 sequence 56-251 (196 bp)	AGTTCTCGACCACATTGGTTCTCTGGTGTGGCTTGGAAGTGGGGGAATCTTTGCTGGCCTTGGAAACAAAGTCTGCTCCCCTGAAATGTATTAGTGGTATAGGCTTTTTACTACTACAGACGGTGATAATTTATCTACGTCTTGTGTACGAGTGCCAGAACTGCTTCTAAACAAACAAAAATATATGATAATTTGA
ASV191	ITS2 Extracted ITS2 sequence 56-251 (196 bp)	AATTCTCAACCTTCCAACTTTTATTAGCTTGGTTAGGCTTGGATGTGGGGGTTGCGGGCTTCATTAATGAGGTCGGCTCTCCTTAAATGCATTAGCGGAACTTTTGTGGACCGTCTATTGGTGTGATAATTATCTACGCCGTGGATGTGAAGCAGCTTTATGAAGTTCTGCTTCGAACCGTCCATTGACTTGGACA
ASV192	ITS2 Extracted ITS2 sequence 56-215 (160 bp)	CAACCCTCGACTTCCCTTTGGGGAAATCGGCGTTGGGGACCGGCCGTATACCGCCGGCCCCGAAATGAAGTGGCGGCCCGTCCGCGGCGACCTCTGCGTAGTAATCCAACTCGCACCGGAACCCCGACGTGGCCACGCCGTAAAACCCCCGACTTCTGAA
ASV193	ITS2 Extracted ITS2 sequence 57-251 (195 bp)	ACACCTCAACTCTCGTGGTCTTCCACGACGAGCTTGGACTTTGGGGGTTTGCTGGCCCTGTGGTCAGCTCCTCTCAAATGAATCAGCCTGCCAGTGTTTGGTGGCATCACGGGTGTGATAACTATCTACGCTCGCCGTTGTCTGCCAGGTAACCCTCAGCGATGAAGGTTCATTGGGGCTCACAGACGTCTCTCC
ASV194	ITS2 Extracted ITS2 sequence 56-161 (106 bp)	CAACCCTCGAACCCCGGTTTTCTTTATGGATCCCGGGGATCGGTGTTGGGGCACTACGGAGGTCTTCTGACCACCGTAGGCTTCGAAATACAGTGGCGGTCCCGCC
ASV195	ITS2 Extracted ITS2 sequence 56-251 (196 bp)	ATTTCTCAACCCCTCTCGATTAGCTTCGAGGGGGAGCTTGGATAGTGGGGGTTTGCAGGAAACTTGGACTTTTAGTCTAGGATTCGAGCTCTCCTGAAATACATTGGCTTGCGGTCGACTTTCGACTTTGTGCGATAAGGCTTTCGGCGTGATAATGATCGCCGTGTGCTGAAGCGCATGACTGTGAAGTTCCGTG
ASV196	ITS2 Extracted ITS2 sequence 56-251 (196 bp)	GAACTATAACGCACTTGGGGATTGTGCCCAGGAGGCTGTCTTGAAGTGGGGGATGCTTGCCTTTTGTGCTGTCTGTCAGGTAGTCGGCTGTTCCTTTGGGGTCCTGTGTGCACCTGTCTTGGGCTTTAGCACGATGGGTGGGCTTCTCTGAAAAGCATTTGTGGGAGCTGCAAGTGACTTGTTTGTTGGGCTATAG
ASV197	ITS2 Extracted ITS2 sequence 56-251 (196 bp)	GATCCATAAGGTGGTATATGCCCTGGTTCGGGTCGCTTATGTGTCCTGAGTTAGCTGGGGGGAGCCGTACAATGGGGATTGTTTGCCTTTCGTGTTGTCTGTCAGGTAGTCGGCTGTTCCTTTGGGGTCCTGTGTGCACCTGTCTTGGGCTTTAGCATGTTGGGTAGGCTTCTCTGAAATGCATTTGTGAGTGTTG
ASV198	ITS2 Extracted ITS2 sequence 56-251 (196 bp)	AATTCTCAAAACCCTTTCTTTTTGGTCTTTCGATCGAAGAAAGGCTTTTGGACTTGGAGGCTTTTTGCTGGTTTCACCTTGAAGCGAGCTCCTCCTAAATGAATCAGTGGGGTCCGCTTTGCTGATCCTTGACGTGATAAGATGTTTCTACGTCTTGGGTTTTGGCACTGTCCCTTGGGCACCTGCTTCAAACCGT
ASV199	ITS2 Extracted ITS2 sequence 56-204 (149 bp)	CAACCCTCGAGCCCTGCTCGGTGATGGGCGACGCCTTGATTTACCAGGCGCGCCCGAAACTCGTTGGCGCCGTCGTCCGGCCCTGAGCGTAGCAAGAGAAATCCCTCGCTCGGTGGACCGTCCGGCGGCCGCCCCGACCACTTTCACAA
ASV200	ITS2 Extracted ITS2 sequence 56-224 (169 bp)	TCACCCCTCAAGCCCTGTGCTTGGTGTTGGACGGCCGGTCGAGCGATCGACCCCTCCTAAAGACAATGACGGCGGCCTGTGGTTCCCCCGGTACACTGAGCTTTTCACCGAGCACGTATCGGACAAGGGCACCCGGGACCCGGTCCTCTCCTTTAAAGGAAACTTCTAT
ASV201	ITS2 Extracted ITS2 sequence 56-211 (156 bp)	CGACCCTCAAGCCCCGGCTTGGTGATGGGCTCCCGCCGCGTGGCGGGCCCGAAACCCGTAGGGCGCCGCGGCAGCGGGCTCTGAGCGTAGCAAGAGCGCAAGCCTCCCTCGCTCCGGAGACCCCTCCACGGCCGCCTGGAGAACACGCACACCGGC
ASV202	ITS2 Extracted ITS2 sequence 56-250 (195 bp)	GGAAGGTGACGCTACTTGGGAATTGTGATGATTCCCAGGAAGCTGTCTTGAAGTGGGGAGTGCTTGCCTTTCATGTTATGTGTGTTGTCTGTCAGGTAGTTGAGCCGTTCCTTTTGGGTCCTGGGCTAAAAAAAAGCATGGTTGGGTAGGCTTCTCTGAAATGCATTTGTGAGTGTCACTTGTGGCTTGCTTTGT
ASV203	ITS2 Extracted ITS2 sequence 56-251 (196 bp)	GGAAGGTGACGCTACTTGGGAATTGTGATGATTCCCAGGAAGCTGTCTTGAAGTGGGGAGTGCTTGCCTTTGTGCTGTCTGTCAGGTAGTCGGCTGTTCCTTTGGGGTCCTGTGTGCACCTGTCTTGGGCTTTAGCATGTTGGGTAGGCTTCTCTGAAATGCATTTGTGAGTGTTGCTTGCGACTTGCTCTGTTGG
ASV204	ITS2 Extracted ITS2 sequence 56-251 (196 bp)	TAATTCTCAACCATGGACCGCCCATGGCTTGGACTTGGGAGCTGCTGGCATCGCAAGACGTCGGCTCTCCTCAAATGCATTAGTGGACCAGCGTGTTCCGGACAGACGTGCACGGCCCCGTTCGACGTGATAACGATCGCCGTCGGGCTGGAGCGTTCCCCCGGACCAAGTCTGCTTCCAACCCTGCCGGGTCCGC
ASV205	ITS2 Extracted ITS2 sequence 56-172 (117 bp)	CACCTTCTATCAAGGTATTGGGAGATGCATACGCACTCCTTAAAAACAGTGGTGATAACTGTCTACTCACGCATAGTAATCTCTGCGACGGCTATTCAGGAACACACCGATTCTCTT
ASV206	ITS2 Extracted ITS2 sequence 56-141 (86 bp)	CAACCCTCATGCCCCTAGGGCGTGGTGTTGGGGATCGGCCAAAGCCCGCGAGGGACGGCCGGCCCCTAAATCTAGTGGCGGACCCG
ASV207	ITS2 Extracted ITS2 sequence 56-250 (195 bp)	AATTCTCAACTCTCTTATACTATTTTGTACAAGAGAGCTTGGATTGTGGAGGCTTGCTGGCACACTTGTTTGTGGTCAGCTCCTCTGAAATGTATTAGCGGAACCGTTTGCGATCTGCCACAAGTGTGATAAACTATCTACACTGACCGGGGGATTGCTCTGTGTTGTTCAGCTACTAATTGTCTCTATTTTGTG
ASV208	ITS2 Extracted ITS2 sequence 56-251 (196 bp)	AATCTTCAACCTTCTCTGTTTCAAGGAAGGCTTGGACTTTGGAGGCTTCTGCTGGCCTTGAAGCCGGCTCCTCTTAAATGGATTAAGCAGGGTCCCCTTTGTCGATCCTCGACGTGATAACATCTTTCTACGTCGGGGGCTTTGGCTCTGCCTGCTTCTTTCTAGTCGCCCCCCCCTTTTCGAAGGGAGGGACTTT
ASV209	ITS2 Extracted ITS2 sequence 56-251 (196 bp)	AATTCTCAACTCTCTTATACTTTTTTGTAAAGGAGAGCTTGGATTGTGGAGGCTTGCTGGCCACTTGTTTGAGGTCAGCTCCTCTGAAATGCATTAGCGGAACCGTTTGCGATCTGCCACAAGTGTGATAAATTATCTACACTGGCCGGGGGATTGCTCTCTGTATTGTTCAGCTACTAATTGTCTCCACTCTGTG
ASV210	ITS2 Extracted ITS2 sequence 56-126 (71 bp)	CAACCATCAGGCCCTGTCCAGCCTGTGTTGGGGCCCTGCGGCTACCGCAGCCCCCTAAATGCAGTGGCGGG
ASV211	ITS2 Extracted ITS2 sequence 56-251 (196 bp)	AATTCTCAACCTTCCAACTTTTATTAGCTTGGTTAGGCTTGGATGTGGGGGTTGCAGGCTTCATTAATGAGGTCGGCTCTCCTTAAATACATTAGCGGAACTTTTGTGGACCGTCTATTGGTGTGATAATTATCTACGCCGTGGATGTGAAACAGCTTTATGAAGTTCTGCTTCTAACCGTCCATTGACTTGGACA
ASV212	ITS2 Extracted ITS2 sequence 56-215 (160 bp)	CAACCCTCGACTTCCCTTTGGGGAAATCGGCGTTGGGGAACGGCAGCATACCGCCGGCCCCGAAATGAAGTGGCGGCCCGTCCGCGGCGACCTCTGCGTAGTAATCCAACTCGCACCGGAACCCCGACGTGGCCACGCCGTAAAACACCCAACTTCTGAA
ASV213	ITS2 Extracted ITS2 sequence 56-200 (145 bp)	CAACACTCAAGCCTAGCTTGGTATTGAACCACGTCCGCAAGGACCGGTTTTAAAATCAGTGGCGGCGCCATCTGGCTCTAAGCGTAGTAATACTCCTCGCTTTTGGGTCCTGATGGATGCTGGCCAGCAACCCCCAACTTTCTAA
ASV214	ITS2 Extracted ITS2 sequence 56-250 (195 bp)	CTCTCTCAAATCTTCGGATTTGGTTTTGAGTGATACTCTTAGTCAGACTAAGCGTTTGCTTGAAAAGTATTGGCATGAGTAGTACTAGATAGTGCTAAACTGTTTCAATGTATTAGGTTTATCCAACTCGTTGATCTGTTTTAGTATTTTTTTAGTATATAGGCTCGGCCTTACAACAACAAACAAAGTTTGACC
ASV215	ITS2 Extracted ITS2 sequence 56-203 (148 bp)	CACCACTCAAGCACGGCTTGGTGTTGGGCGACGTCCCCTCCTCGGGGACGCGCCTCGAAACGCTCGGCGGCGTGGCACCGGCTTTAAGCGTAGCAGAATCTTTCGCTTTGGAAGTCGGGGCCCCGTCTGCCGGAAGACCTACCTTCAA
ASV216	ITS2 Extracted ITS2 sequence 56-185 (130 bp)	CTCCCTCAAACCGTTGGGTTTGGTGTTGAGCAATACGCGATACGGTTTGTTTGAAATATAGTAATGTACCGACGTAAACGACTTAGGTCTAACCAAAACGTTTTCTTTGGGTACTCATGCTTTTTTCAAC
ASV217	ITS2 Extracted ITS2 sequence 56-202 (147 bp)	CACCACTCAAGCCTGGCTTGGTGTTGGGCGACGTCCGCTTTTGGGGACGCGTTTCGAAACGCTCGGCGGCGTGGCACCGGCTTTAAGCGTAGCAGAATCTTTCGCTTTGAAAGTCGGGGCCCCGTCTGCCGGAAGACCTACTCGCAA
ASV218	ITS2 Extracted ITS2 sequence 56-218 (163 bp)	CAACCCTTAAGCCTAGCTTAGTGTTGGGAGCCTACTGCTTTTGCTAGCTGTAGCTCCTGAAATACAACGGCGGATCTGCGATATCCTCTGAGCGTAGTAATTTTTATCTCGCTTTTGACTGGAGTTGCAGCGTCTTTAGCCGCTAAATCCCCCAATTTTTAAT
ASV219	ITS2 Extracted ITS2 sequence 56-207 (152 bp)	AAGTATCAAAACACTTGTGTTGTCGAGTGCTTTTGGATTGTGGGAGTGCTAGCCAGTTTCTAGCTCTCCTGAAAAATATTGGCTTTGAAAGACAAATTGGTGTGATAATATTTCTGCACTTGCATGTCTCTCAGCCTCATTTTTTATGATTC
ASV220	ITS2 Extracted ITS2 sequence 56-251 (196 bp)	AATTATCAAAACCCTTTTTCTTTGATCCTTTTTGGAGCGGAAAAGGACTTTTGGACTTGGAGGTTCAATGCTCGCTTTCGCCTTTGAAAGCGAGCTCCTCTCAAATGAATTAGTGGGGTCTGCTTTGCCGATCCTTGACGTGATAAGATGTTTCTACGTTTTGGATTTGGCACTGTCCCTTGGACGTCCGCTCCTA
ASV221	ITS2 Extracted ITS2 sequence 56-251 (196 bp)	GAACCATAACGCACTTGGGAATTGTGCCCAGGAGGCTGTCTTGAAGTGGGGAGTGCTTGCCTTTCATGTTATGTGTGTTGTCTGTCAGGTAGTTGAGCCGTTCCTTTTGGGTCCTGTGCGCACACCCTGTCTGGGCTAAAAAAAAAGCATGGTTGGGTAGGCTTCTCTGAAATGCATTTGTGAGTGTCACTTGTGG
ASV222	ITS2 Extracted ITS2 sequence 56-149 (94 bp)	GGACCCTCGGGCCTAGTGGTGACATCCACCATGTGGCCCGGTGTTGGGGACCCGCGGCTGCCGCGGCCCCCTAAAGACAGTGGCGGACCCGTTT
ASV223	ITS2 Extracted ITS2 sequence 56-250 (195 bp)	AATTCTCAACTCTCTTATACTATTTTGTAAAGGAGAGCTTGGATTGTGGAGGCTTGCTGGCCACTTGCTTGGGGTCAGCTCCTCTGAAATGCATTAGCGGAACCATTTGCGATCTGCCACAAGTGTGATAAACTATCTACACTAGCCGGGGGATTGCTCTGTCTTGTTCAGCTACTAATTGTCTCTACTATATGA
ASV224	ITS2 Extracted ITS2 sequence 56-251 (196 bp)	CTCTCTCAAACCTTCGGGTTTGGTATTGAGTGATACTCTTAGTCGGACTAGGCGTTTGCTTGAAATTTATTGGCATGAGTGATGCTAAGAAGTGCATTCAGGAAATATCAATGTATTAGGTTTATCCAACTCGTTGACAATTCTTGGTTGTGAATTTTTAGTGTTAGGCTTTGCCTTAAAAAACAACAAACAAGTT
ASV225	ITS2 Extracted ITS2 sequence 56-134 (79 bp)	CAACCCTCGAACCCCTCCGGGGGGTCGGCGTTGGGGATCGGCCCTTTACGGGGCCGGCCCCGAAATACAGTGGCGGTCT
ASV226	ITS2 Extracted ITS2 sequence 56-251 (196 bp)	AATATCTCAAAAAGCTTGTGCTTTTTTGGCACAGGAGTTTTGGACATTGGGAGTTGCCGGCTGCTGGATAACAGTGGTGGGCTCTTCTGAAAAGCATTAGTTGAGGAGCTTTGCACTCTATTGGTGTGATAGACTATCTATGCCAGGAGATGCTTCATGATCCTCTGCCATCTAACCGTCTTTATAAGACAATATG
ASV227	ITS2 Extracted ITS2 sequence 53-141 (89 bp)	CACCCTCTCGCAAGGTGTTGGGTAGCAACTTTCTACCTAAAATAGTCTGGATCTTATCGTACTACGTTTCGCTAACAATCCACCACCCC
ASV228	ITS2 Extracted ITS2 sequence 56-251 (196 bp)	GAACCATAACGCACTTGGGAATTGTGCCCAGGAGGCTGTCTTGAAGTGGGGAATGCTTGCCTTTTGTGCTGTCTGTCAGGTAGTCGGCCGTTCCTTCGGGGTTCTGCATGCACCTGTCTTGGGCTTTAGCAGGTTGGGTAGGCTTCTCTGAAATGCATTTGTGAGTGTTGCTTGCGACTTGCTCTGTTGGGTTTAT
ASV229	ITS2 Extracted ITS2 sequence 56-221 (166 bp)	TCACCTCTCAAGCCTAGCTTGCAGTTGGATCATTAGCCAAGATTTTTGACAGCCTGGCTGGTCCCAAAGATAATGACGGTGTCTGTGAACGACCCCTAGTACACTGAGCTCTCATGTAGCACGTACTTTGGAGTTCCAGGCCCGGTCTATTCATTTTTTCATCTCA
ASV230	ITS2 Extracted ITS2 sequence 56-251 (196 bp)	AAACCTCGAACCAAAGTCCTTCGATCCGTCGGAGCTTTGTTTTCGGACCATGGGAGCATGCGGGCGGCGACGTCGGCTCTCCTCAAAAGCATTAGCTGTGGGCGGCGAGCCTTGCGTGACACACGGCCTTGTTCGACGTCGTAATGATCGTCGTGGGCTGGAGGCGCGTGGATCGACCAGTCTCATGCTTCGCAAC
ASV231	ITS2 Extracted ITS2 sequence 61-251 (191 bp)	ATTGTTTCGAACGACAGCTTTTTTCAGTAAGAGCTGGCGGATCGGTATTGAGGGTCTTTTTGCCATTTACCGTGGCTCCCTCGAAATGCATTAGCGCATCCATTTGATAGGCGAAAGACGGACGAAAGCTTGATTTTTCGCCCTCTCTTCCCTGCCGGGTTTTGATAATATCAGGACTTCGGAGGCGGAGA
ASV232	ITS2 Extracted ITS2 sequence 56-228 (173 bp)	TCACCCCTCAAGCCCCGTGCTTGGTGTTGGACGGCCTGGCTGGGCGTGCTGCCCGGCCCCTCCTAAAGACAATGACGGCGGTCCGTGGAACCCCCGGTGCACTGAGCTTCTTCACCGAGCACGTACCGGAGACAGGGCGCCCGGGCGACGGTCTGAAACCCCTTATTTCTCAA
ASV233	ITS2 Extracted ITS2 sequence 56-250 (195 bp)	AATATCTCAAAAAGCTTGTGCTTTTTTGGCATGGGATTTTTGGACATTGGGAGTTGCCGGCTGCTGATACAGTGGTGGGCTCTTCTGAAAAGCATTAGTCGAGGAGCTTTGCACTTCTATTGGTGTGATAGACTATCTATGCCAGGAGATGCATCATGATCCTCTGCTGTCTAACTGTCTTTATCAGACAATATG
ASV234	ITS2 Extracted ITS2 sequence 56-250 (195 bp)	AATTCTCAACCCCTCTCGATTGTTTTTCGAGGGGGAGCTTGGATGGTGGGGGCTGCCGGAGACTAGGACCTCGTCCTTGACTCGGGCTCTCCTTAAATGCATTGGCTTGCGGTCGACTTTCGACTTTGCGCGACAAGGCTTTCGGCGTGATAATGATCGCCGTTCGCTGAAGCGCACGAACGAACGTTCCGTGCC
ASV235	ITS2 Extracted ITS2 sequence 56-172 (117 bp)	CACCTTCTACAAAGGTTTTGGGGATTGCACTGCAGCCCTTAAAGAACTTGGTGGTAACTGGAACCCACGCACAGTAATCTCTGCGAAGGCGACCAGGTAAACACCGAAAACTCTTCT
ASV236	ITS2 Extracted ITS2 sequence 56-251 (196 bp)	AATTCTCAACCTTCCAACTTTTATTAGCTTGGTTAGGCTTGGATGTGGGGGTTGCGGGCTTCATTAATGAGGTCGGCTCTCCTTAAATGCATTAGCGGAACTTTTGTGGACCGTCTATTGGTGTGATAATTATCTACGCCGTGGATGTGAAACAGCTTTATGAAGTTCTGCTTCTAATCGTCCATTGACTTGGACA
ASV237	ITS2 Extracted ITS2 sequence 58-251 (194 bp)	ATCGTTGCCCCCTCCCAAACCCCCCTCTCCTCGAAAGGGGACGAGGGGACTTGGCCGTGGGCGGATATTGGCCTCCCGTCTGCCGAATGGCTCGCGGTTGGCCTAAATACGAGTCGTCGGCGACGGATGCCGTGACGTTCGGTGGTCAAAGAAACCTCGAGCTCCCGTCGCGCGTACGTCGTCGGTCCGATAAG
ASV238	ITS2 Extracted ITS2 sequence 56-215 (160 bp)	CAACCCTTAAGCCTAGCTTAGTGTTGGGAATCTACTTCTCTTAGGAGTTGTAGTTCCTGAAATACAACGGCGGATTTGTAGTATCCTCTGAGCGTAGTAATTTTTTTCTCGCTTTTGTTAGGTGCTATAACTCCCAGCCGCTAAACCCCCAATTTTTTGT
ASV239	ITS2 Extracted ITS2 sequence 56-218 (163 bp)	CAACCCTTAAGCCTAGCTTAGTGTTGGGAGCCTACTGCTTTTGCTAGCTGTAGCTCCTGAAATACAACGGCGGATCTGCGATATCCTCTGAGCGTAGTAATTTTTATCTCGCTTTTGACTGGAGTTGCAGCGTCTTTAGCCGCTAAATCCCCTAATTTTTAAT
ASV240	ITS2 Extracted ITS2 sequence 56-251 (196 bp)	CATCATCAAACCTTCTTGGTCCTCTGGGATCAGGAAGGCTTTGGACTCTGGAGGCATTTTGCTGGCTTCCCGTGAAGCCAGCTCCTCTTAAATGGATTAGTGGGGTCCCCATTGTGGCTCCCTTGACGTGATAAGATGCTTCTACGTCTCGGGACAGGCTCTGTGACCCGCTTCGAACCGTCTCGTCAGAGACAAC
ASV241	ITS2 Extracted ITS2 sequence 56-251 (196 bp)	AGTCATCAACCTCTCCCGTTTTGCGACGGGTCCGGGTTGGAGCCTGGGGGCTTGCGGCCGCGAGGCTGCTCCCCCCAAATGCATCGGTTGGGCCTGCGGGTCGGACTCGGTTGGGCGTTGTACCATCCTCGCTCTTATTCCGAGATGTTCCCCTATTAATGTGCCCTCCCATGACCGCCCCGTCTGGAGTCGGCGG
ASV242	ITS2 Extracted ITS2 sequence 56-251 (196 bp)	AGTCATCAACCTCTCCCGTTTTGCGACGGGTCCAGGTTGGAGCCTGGGGGCTTGCGGCCGCGAGGCTGCTCCCCTCAAATGCATCGGTTGGGCCTGTGGGTCGGACTCGGTTGGGCGTTGTACCATCCTCGCTCTTATTCCGAGATGTTCCCCTATTAATGTGCCCTACCACGACCGCCCCGTCTGGAGTCGGCGG
ASV243	ITS2 Extracted ITS2 sequence 56-251 (196 bp)	GAACTATAACGCACTTGGGGATTGTGCCCAGGAGGCTGTCTTGAAGTGGGGAATGCTTGCCTTTTCATGCCTTTCATGTTTGTCTGTCAGGTAGTTGAGCCGTTCCTTTTGGTTCTGTGCACACCCTGTTGCGGGCCCTGTCTTGCATGTTGTTGGTAGGCTTCTCTGAAATGCATTTGTGAGTGTTGCTTGCGAC
ASV244	ITS2 Extracted ITS2 sequence 56-251 (196 bp)	AAACCCATCGCGTCGCGGATTGTCATGATCTGCGGGGCGGATTTGGACGCTGCCGTAGTTGGCTCGTCTCGAAATGCATTAGCCAGTCCGAGGACGCGCGCCACTGGTGTGATAATTCACTTTGCGCCGCTGGTGTGTCCGACGAAGGCTCATAATCGCCCGCAAGGGCAACATTTTAATGCTCTGGCCTCAAATC
ASV245	ITS2 Extracted ITS2 sequence 56-250 (195 bp)	AAACCTCGGATCGACGCTTCGACCCCGTCGGAGCTCGGTCTGGACTTGTGGGAGTCTGCGGGCGAAGCGTGACTTCGTCGGCTCTCCTCAAAAGCATTAGCCGTGGGTGGCGAGCCTGGCATGGCACGGCCCCTTCGACGTCGTAATGATCGTCGTGGGCCGGAAGCGTGTACGGCTCGACGGGACCCATGCTTC
ASV246	ITS2 Extracted ITS2 sequence 56-135 (80 bp)	CACCACTCAAGCACTGCTTGGTATTGGGCATCGTCCGTCGAAAGACGGGCGTGCCTCGAAGACCTCGGCGGGGCCTAACC
ASV247	ITS2 Extracted ITS2 sequence 56-130 (75 bp)	CACCCCTCAAGCTCTGCTTGGTGTTGGGGGGACCTCGCCCCGGTTTTGGGGCGCCCCCGAAAATCAGCGGCGGTG
ASV248	ITS2 Extracted ITS2 sequence 56-131 (76 bp)	CAACCCTCGAACCCCTCCGGGGGGTCGGCGTTGGGGATCGGCCCCTCACCGGGCCGCCCCCGAAATACAGTGGCGG
ASV249	ITS2 Extracted ITS2 sequence 56-216 (161 bp)	AAGTTCTCTCAACCACTAGATGTGGCTTTGGATGTGGGGGTTTGCTGGCTTTAGTCGGCTCTCCTGAAAAGTATTAGCGGTGTCTGGACTGCTAAGGTGTGATAAATTATCTATGCCTTTTTGGTTTCCATGTCATGCTGCTTCCAATGAATATCTGATGA
ASV250	ITS2 Extracted ITS2 sequence 56-251 (196 bp)	GAACCGTAAAGTACCTGGGAGAATTGTGCCTAGAAGGCTGTCTTGAAGTGGAGAGTGCTTGCCTTTTGTATTGTCTGTCAGGTGGTTGGCCATTCCTGTGCATGCCTGTCTTGGGCTTTAGCATGTTGGATAGACTTCTCTGAAATGCATTTGTGAGCATTGCAAGTGACTTGCTTTGTTGGGTTTAATAGGTGTC
ASV251	ITS2 Extracted ITS2 sequence 56-201 (146 bp)	CACCACTCAAGCCTGGCTTGGTGTTGGGCGACGTCCCCTTTGGGGACGCGCCTTAAAACGCTCGGCGGCGTGGCACCGGCTTTAAGCGTAGCAGAATCTTTCGCTTCGAAAGTCGGGGCCCCGCCTGCCGGAAGACCTACTCACAA
ASV252	ITS2 Extracted ITS2 sequence 56-209 (154 bp)	GTACCTTCAAGCTCTGCTTGGTGTTGGGTGTTTGTCTCGCCTCTGCGTGTAGACTCGCCTTAAAACAATTGGCAGCCGGCGTATTGATTTCGGAGCGCAGTACATCTCGCGCTTTGCACTCATAACGACGACGTCCAAAAGTACATTTTTACAC
ASV253	ITS2 Extracted ITS2 sequence 56-251 (196 bp)	GAACTATAACGCACTTGGGGATTGTGCCCAGGAGGCTGTCTGTCAGGTAGTCGGCTGTTCCTTTGGGGTCCTGTGTGCACCTGTCTTGGGCTTTAGCATGTTGGGTAGGCTTCTCTGAAATGCATTTGTGAGTGTTGCTTGTGACTTGCTCTGTTGGGTTTATAGGCGTCATAGTTTTATGCGCCGGTGAGTCTGC
ASV254	ITS2 Extracted ITS2 sequence 56-220 (165 bp)	CACCACTCAAGCATTGCTTGGTATTGGGCACTCGTCCGCCGCAAGGCGGGCGTGCCTCGAAGACCTCGGCGTGGCCTAACCGGCTTCGGGCGTAGTAGAGTTAAATCGAACGTCTTATAAGTCTGGATAGGTTCCACTTTGCCGTAAAACCTTTTAAATTTTCTA
ASV255	ITS2 Extracted ITS2 sequence 56-251 (196 bp)	AAACCCTCAACCTTCTCGGTTTTGCCGAAGGAGGCTTGGACTTTGGAGGCCTTTGCTGGCGTCCTTCTTTTGAAGGCCCAGCTCCTCTTAAATGAATTAGCGGGGTCCTCTTTGCCGATCCTCGACGTGTGATAAGATGTTTCCATGTCTTGGCTTTCCGGCTCTGTTGCTTTTGGGACCCGCTTCCAACTGTCTC
ASV256	ITS2 Extracted ITS2 sequence 56-136 (81 bp)	CAACCCTCGAACCCCTCCGGGGGGTCGGCGTTGGGGATCGGCCCTTTACGGGGCCGGCCCCGAAATACAGTGGCGGTCTCG
ASV257	ITS2 Extracted ITS2 sequence 56-134 (79 bp)	CAACCCTCAAGCCCCCGGGTTTGGTGTTGGGGATCGGCGAGTCTTAGGACCAGCCGCCCCCTAAATCTAGTGGCGGTCT
ASV258	ITS2 Extracted ITS2 sequence 56-207 (152 bp)	AAGTATCAAAACACTTGTGTTGTCGAGTGCTTTTGGATTGTGGGAGTGCTAGCCAGTTTCTAGCTCTCCTGAAAAATATTGGCTTTGAAAGACAAATTGGTGTGATAATATTTCTGCACTTGCATGTCTCTCAGCCTCATTTTTTATGATTC
ASV259	ITS2 Extracted ITS2 sequence 56-135 (80 bp)	CACCACTCAAGCACTGCTTGGTATTGGGCATCGTCCGTCGAAAGACGGGCGTGCCTCGAAGACCTCGGCGGGGCCTAACC
ASV260	ITS2 Extracted ITS2 sequence 56-215 (160 bp)	CAACCCTTAAGCCCTGTTGCTTAGCGTTGGGAGCCTACAGCACCCGCTGTAGCTCCTCAAAGTTAGCGAGCGGAGTCGGCCTCACACTCTGGACGTAGTACATCTCTCTCGTCTATCAGTGGAACCGGTCTCCCGCCGTAAAACACACCAAATTCTTTTA
ASV261	ITS2 Extracted ITS2 sequence 56-251 (196 bp)	ATCTCTCAACCCCTCTTGATTAGCTTCGAGGGGGAGCTTGGATAGTGGGGGTTTGCAGGAAACTTGGACTTTTCATAGTCTAGGATTCGAGCTCTCCTGAAATACATTGGCTTGCGGTCGACTTTCGACTTTGCGCGATAAGGCTTTCGGCGTGATAATGATCGCCGTGTGCTGAAGCGCATGACTGTGAAGTTCC
ASV262	ITS2 Extracted ITS2 sequence 56-251 (196 bp)	AATATCTCAAAAAGCTTGTGCTTTTTTGGCACAGGAGTTTTGGACATTGGGAGTTGCCGGCTGCTGGATAACAGTGGTGGGCTCTTCTGAAAAGCATTAGTTGAGGAGCTTTGCACTCTATTGGTGTGATAGACTATCTATGCCAGGAGATGCTTCATGATCCTCTGCCATCTAACCGTCTTTATAAGACAATATG
ASV263	ITS2 Extracted ITS2 sequence 56-155 (100 bp)	CACCAATCAAGCACCGCTTGGTATTGGGGATGGTCCCGGCCCTCTCGAGGCGCCGGGGCCTCTCCCGAAATGTATCGGCGAGGACCTCCGACCCCCGACG
ASV264	ITS2 Extracted ITS2 sequence 56-137 (82 bp)	CAACCCTTAAGCCCCCGTTGCTTAGCGTTGGGAGCCCCGCAGCCCTCCCGCTGCGGCCCCCCCAAAGTCAGTGGCGGGGGCC
ASV265	ITS2 Extracted ITS2 sequence 55-250 (196 bp)	AATCAATCTCAACTTTAACATTTTGTGTATAAGTTGGATCTGGAGGTCTGCCGTCGAACTTGTTCACGGCTCTTCCTAAATATATTAGCGGCTTGGTGATTACACCGTTAGCTTGATATTATGTCTATGCTGCGGCTGAATTATTCCAGTGCTTCTAATCGTCTTTAGACATTATTCTGTGCTCGGGCCTCAAATC
ASV266	ITS2 Extracted ITS2 sequence 56-251 (196 bp)	GAACTATAACGCACTTGGGGATTGTGCCCAGGAGTGGGGAGTGCTTGCCTTTTCATGCCTTTCATGTTTGTCTGTCAGGTAGTTGAGCCGTTCCTTTTGGTTCTGTGCACACCCTGTTGCGGGCCCTGTCTTGCATGTTGTTGGTAGGCTTCTCTGAAATGCATTTGTGAGTGTTGCTCGCGGCTTGCTTTGTAGG
ASV267	ITS2 Extracted ITS2 sequence 56-202 (147 bp)	CTCTCTCAAACCCCCGGGTTTGGTATTGAGTGATACTCTTAGTCGGACTAGGCGTTTGCTTGAAAAGTATTGGCATGGGTAGTACTGGATAGTGCTGTCGACCTCTCAATGTATTAGGTTTATCCAACTCGTTGAATGGTGTGGCGG
ASV269	ITS2 Extracted ITS2 sequence 56-143 (88 bp)	CAACCCTCATGCCCCTAGGGCGTGGTGTTGGGGATCGGCCAAAGCCCGCGAGGGACGGCCGGCCCCTAAATCTAGTGGCGGACCCCTC
ASV270	ITS2 Extracted ITS2 sequence 56-220 (165 bp)	AACTATCAAAACACACACACCTTTCTTGGTTGGGTGTTTTGGACTTTGGGAGCATTTTGCTGGTCTGTCTGAGCCAGCTCTCCTTAAAAGCATTAGCTTTGGAGACCATCAGTGTGATAACTTTGTTTACACTGACTGAGTGTGTCTCTGCTTCTTGAATGTCCC
ASV271	ITS2 Extracted ITS2 sequence 56-251 (196 bp)	AATTCTCAACCTTTATCAACTTTTGCTGATAATTGGCTTGGATATGGGGGTCTTTTTGCTGGCTTCTTCACAGATGGTCAGCTCCCCTTAAATGCATTAGCCGGTGCCCCGCGTGGACTGTCTATTGGTGTGATAATTATCTACGCCGTGGACATCTGCAATCATATGGGTTTGCACTGCTTCCAACTGTCTGTTC
ASV272	ITS2 Extracted ITS2 sequence 56-208 (153 bp)	CTGCCCTCAAGCACGGCTTGTGTGTTGGGTGCGGTCCCCCCGGGGACCTGCCCGAAAGGCAGCGGCGACGTCCGTCTGGTCCTCGAGCGTATGGGGCTTTGTCACTCGCTCGGGAAGGACCTGCGGGGGTTGGTCACCACCACATTTTACCAC
ASV273	ITS2 Extracted ITS2 sequence 58-251 (194 bp)	GCCGTTGCCCCCTCCACTCCCTCGGGATTGCGGGGGGCGGATGATGGCCTCCCGTGCGCTCCGTCGCGCGGTTGGCGTAAATACCAAGTCCTCGGCGGCGTACGCCACGACAATCGGTGGTTGCGAAACCTCGGTTGCCTGTCGTGTGCGGTCGTCGCGCATCGAGGGCTTGAAAAATTGCTCGGCTCCGGCTT
ASV274	ITS2 Extracted ITS2 sequence 56-148 (93 bp)	CAACCCTCAGAACCCCCGTATTTTTGTACGGGGCGTGCTGGTGTTGGGGCCTTCTGCGGCTGCCGCAGGCCCTGAATAACAGTGGCGGGCTCC
ASV275	ITS2 Extracted ITS2 sequence 56-126 (71 bp)	TGACCAATCAAGCTCTGCTTGGCCTTGAGGCACGCTATACTAGCGGCCTTTAAAATCAGTGGCGGTGCCGT
ASV276	ITS2 Extracted ITS2 sequence 56-200 (145 bp)	CAACACTCAAGCCTAGCTTGGTATTGAGCCACGTCCGCAAGGGCCGGCTTTAAAGTCAGTGGCGGCGCCATCTGGCTCTCAGCGTAGTAATACTCCTCGCTGTTGGGTCCTGGTGGATGCTTGCCAGCAACCTCCAACCTTCTAA
ASV277	ITS2 Extracted ITS2 sequence 56-198 (143 bp)	TGACCACTCAAGCCCGGCTTGGTGTTGGGGTCCGCGGTCCCGCGGCCCTTAAAATCAGTGGCGGCGCCATCTGGCTCTAAGCGTAGTAATACTCCTCGCTATAGGGTTCCCGGTGGATGCTTGCCATCAACCCCCAATCTCAC
ASV278	ITS2 Extracted ITS2 sequence 56-147 (92 bp)	CCATCCCCTCAAGCTCTGCTTGGCTGGTTGGGTCGACGTCCACCCGTGGCCTTGGGCCGGGGGGGGGACGGGCCCGAAAGGCAGTGGCGGTT
ASV279	ITS2 Extracted ITS2 sequence 56-202 (147 bp)	GGAAGGTGACGCTACTTGGGAATTGTGATGATTCCCAGGAAGCTGTCTTGAAGTGGGGAGTGCTTGCCTTTCATGTTATGTGTGTTGTCTGTCAGGTAGTTGAGCCGTTCCTTTTGGGTCCTGTGCGCACACCCTGTCTGGGCTAAA
ASV280	ITS2 Extracted ITS2 sequence 56-251 (196 bp)	CTCTCTCAAAACTCTAAGTTTTGGTGTTGAGTGATACTCAAGGCAAGCTTGAGTTTGCTTGAAAAGTATTGGCAAGGGAAGCGATTCTTCGCTCCGGCTATTTATTCAATGTATTAGGTTTATCCAACTCGTTGATTGATGGCAGGATGAAAGGAGTCTGCTAAGGCCCGGCCTTACAACTAAACAAACCAAAGTT
ASV281	ITS2 Extracted ITS2 sequence 56-163 (108 bp)	CAACCCTCGAGCCCGACTCTTCGGAGGACGGCTCGGCGTTGGGGGACGGCAGACTCCCCCCGGCATCTCGCCGGGGACGCCGCCCCCGAAATTTAGTGGCGGCCCTCC
ASV282	ITS2 Extracted ITS2 sequence 56-207 (152 bp)	AAGTATCAAAACACTTGTGTTGTCGAGTGCTTTTGGATTGTGGGAGTGCTAGCCAGTTTCTAGCTCTCCTGAAAAAAATTGGCTTTGAAAGACAAATTGGTGTGATAATCTTTCTGCACTTGCATGTCTCTTAGCCCCAATTTTTATGATTC
ASV283	ITS2 Extracted ITS2 sequence 56-251 (196 bp)	ACATCTCAAGACCCTGTCTGCTTTTGATAGGTATTGGATTTTGGGGGTTGCAGGCTGTTTCAGATTGCTTGCTCTCCTTGAATGTATTAGTGGAGAAAATCCATTGAACTCCTTTGGTGTGATAACGTCTATCAATGCCAGGAGCAATGTGTCAGTTGTCTCTGCTGTCTAACCTAGCTGTCCATAAACATGGACA
ASV284	ITS2 Extracted ITS2 sequence 56-251 (196 bp)	GGAAGGTAACGCTACTTGGGAATTGTGATGATTCCCAGGAAGCTGTCTTGAAGTGGGGAGTGCTTGCCTTTCATGTTATGTGTGTTGTCTGTCAGGTAGTTGAGCCGTTCCTTCGGGGTTCTGCGTGCACCTGTCTTGGGCTTTAGCAGGTTGGGTAGGCTTCTCTGAAATGCATTTGTGAGTGTTGCTTGCGACT
ASV285	ITS2 Extracted ITS2 sequence 56-203 (148 bp)	CACCACTCAAGCCTCGCTTGGTATTGGGCAACGCGGTCCGCCGCGTGCCTCAAATCGACCGGCTGGGTCTTCTGTCCCCTAAGCGTTGTGGAAACTATTCGCTAAAGGGTGCTCGGGAGGCTACGCCGTAAAACAAACCCATTTCTAA
ASV286	ITS2 Extracted ITS2 sequence 56-135 (80 bp)	CAACCCTCAAGCCCCCGGGTTTGGTGTTGGGGATCGGCGAGTCTTAGGACCAGCCGCCCCCTAAATCTAGTGGCGGTCTC
ASV287	ITS2 Extracted ITS2 sequence 56-132 (77 bp)	CACCACTCAAGCATTGCTTGGTATTGGGCATCGTCCGTCGTAAAGGCGGGCGTGCCTCGAAGACCTCGGCGGGGGTT
ASV288	ITS2 Extracted ITS2 sequence 56-216 (161 bp)	TCACCATATCAAGCTTGGCTTGTTGTTGGGCCCTTTTGTCACCTGGTGACAGGTCCAAAAGATAATAACTGGTGTCATACAGACTCTATATGCAACGAGCTTACAACAGCACGCATCTGGTGGTCGTGTGGCCCGGTTTTCACTTTAAATATATTTCTCAA
ASV289	ITS2 Extracted ITS2 sequence 56-251 (196 bp)	CCCCCATACTCAAGCGTCCTTTTTAATGATGCTTGGATTGCTTTGGAGAGGTGTCATGTTATCAAGAAGCCCTCCAGAAATTTATAGGCAGTATGGTTTGCACCAGAACCAGACGTAATAATAATAAAATCGTCTCTTTTGGGTATAATCATTGTACTTGCCTTTGAATCACCCATGTTGATTTTTGGGTGACCTC
ASV290	ITS2 Extracted ITS2 sequence 56-208 (153 bp)	GTACCTTCAAGCTCTGCTTGGTGTTGGGTGTTTGTCGCGCTTTGTGCGTGGACTCGCCTTAAATCCATTGGCAGCCGGCAGTCTGGTGTTGGAGCGCAGCACATTTTGCGCACTAGACCACGAATGTCGGCGTCCATAGGCCTACAATTTTGC
ASV291	ITS2 Extracted ITS2 sequence 56-210 (155 bp)	TCACGGTATCAAGCTTGGCTTGTTGTTGGGCCCTTTGTCACCTGGTGACAGGCCCGAAAGGCAATGACTGGTGTAACAGACTCCATATGCAACGAGCTTATCACAGCACGCATCTGGCAGTTGATGTGACCCGGTCTTCACTCCTTCTTTCTCAA
ASV292	ITS2 Extracted ITS2 sequence 56-201 (146 bp)	CACCACTCAAGCCCGGCTTGGTGTTGGGCGACGTCTCCTTTAGGGACGCGCTTCGAAACGCTCGGCGGCGTGGCACCGGCTTTAAGCGTAGCAGAATCTTTCGCTTTGAAAGTCGGGGCCTCGTCTGCCGGAAGATCTACTCGTAA
ASV293	ITS2 Extracted ITS2 sequence 56-221 (166 bp)	CAACCCTCGAACCCCTCCGGGGGGTCGGCGTTGGGGATCGGCCCTTTACGGGGCCGGCCCCGAAATACGGTGGCGGTCTCGCCGCAGCCTCTCCTGCGCAGTAGTTTGCACACTCGCATCGGGAGCGCGGCGCGTCCATTGCCGTAAAACACCCAACTTTCTGAAA
ASV294	ITS2 Extracted ITS2 sequence 56-198 (143 bp)	CACCACTCAAGCCTCGCTTGGTATTGGGCACCGCGGGCGACCGCGCGCCCCAAATTCACCGGCTGAGCCGTCCGTCTCTAAGCGTTGTGGCAACTATCCGCTTGCGAGGCCCGGGCGACCCGGCCGTTAAACCCCCCATCAAA
ASV295	ITS2 Extracted ITS2 sequence 56-219 (164 bp)	ACACCCTCAAGCTCTGCTTGGTGTTGGGCGTCTGTCCCGCCGCTTGCCGGCGTGAGGACTCGCCTCAAAGGTATTGGCAGCGGCCTTTGTCAGCTTCTCGCGCAGCGAAGATTGCGTCGATTGGGGCATGGCAGTGGGTTCGCGTCCACAAAAAGTACACCATG
ASV296	ITS2 Extracted ITS2 sequence 56-193 (138 bp)	CAACCCTCAAGCCTGGCTTGGTATTGGGCTTCGCCGTTTTGGCGGGCCTTAAAATCAGTAACAGTGTCGTTGGGGCCCTGAGCGTAGTACATATCCTCGCTATAGGGATTTCCACGGCCATTAACCCTCACTTTCTAA
ASV297	ITS2 Extracted ITS2 sequence 58-251 (194 bp)	ATCGCGTCGCCCCACCCCCTCACGGGGGTCGGGGCGGAAATTGGCCTCCCGTGCACCCACGTGCGCGGCTGGCCCAAACCGAGACCCCGTGGCCGCAAAACGGCGCGACGAACGGTGGAGTAGACCCTACGCATCGCTTCGCGCCGATAGCGGTCCTGCTGTGGCCAGTGAAACCCTTCCAAATAAATCGTTGC
ASV298	ITS2 Extracted ITS2 sequence 56-201 (146 bp)	CACCACTCAAGCTTGGCTTGGTGTTGGGCGACGTCCCCTTTGGGGACGCGCCTCGAAACGCTCGGCGGCGTGGCACCGGCTTTAAGCGTAGCAGAATCTTTCGCTTCGAAAGTCGGGGCCCCGTTTGCCGGAAGACCTACTCGCAA
ASV299	ITS2 Extracted ITS2 sequence 56-126 (71 bp)	CAACCCTCAAGCACTGCTTGGTATTGGGTTCCGCTGCTCACCCAGCGGGCCTTAAAATTAGTGGCGGTGCC
ASV300	ITS2 Extracted ITS2 sequence 56-250 (195 bp)	ACATCCTTCAACCTTTCTTGGTTTCTTGACCGGGGAAGGCTTGGACTTTGGGGGTTTTCATTGCTGGCCTCCCTTGAAGCCAGCTCCTCCTAAATGGATTAGTGGGGTCTGCTTTGCCGATCCTTGACGTGATAAGATGTTTCTACGTCTTGGGTTTCGCACTGTCGCTTCAGACCCCGCTTCAAACAGTCTTGC
ASV301	ITS2 Extracted ITS2 sequence 56-251 (196 bp)	AATTCTCAACCATGTCTCGATAGACTTCGAGGGATGGCTTGGAGATGGGGGTTGCCGGCGTCGGAGCGTTGTCGGCTCTCCTGAAATGCATTAGCGATGGGGACAGCAAAGTCTCTCGGACATGCCTGGTCTTTTCGATGTGATAATGATCGTCGTGGGGGCTGGGGTTTGCAGGGAAGAGGGATGGTCTGATCGC
ASV302	ITS2 Extracted ITS2 sequence 56-251 (196 bp)	AGTCATCAACCTCTCCCGTTTTGCGACGGGTCCAGGTTGGAGCCTGGGGGCTTGCGGCCGCGAGGCTGCTCCCCTCAAATGCATCGGTTGGGCCTGCGGGTCGGACTCGGTTGGGCGTTGTACCATCCTCGCTCTTATTCCGAGATGTTCCCCTATTAATGTGCCCTACCACGACCGCCCCGTCTGGAGTCGGCGG
ASV303	ITS2 Extracted ITS2 sequence 56-132 (77 bp)	CAACCCTCAAGCCCCCGGGTTTGGTGTTGGGGATCGGCGAGCCCTTGCGGCAAGCCGGCCCCGAAATCTAGTGGCGG
ASV304	ITS2 Extracted ITS2 sequence 56-251 (196 bp)	GATCCATAAGGTGGTATATGCCCTGGTTCGGGTCGCTTATGTGTCCTGAGTTAGCTGGGGGGAGCCGTACAATGGGGATTGTTTGCCTTTCGTGTTGTCTGTCAGGTAGTCGGCCGTTCCTTCGGGGTTCTGCGTGCACCTGTCTTGGGCTTTAGCAGGTTGGGTAGGCTTCTCTGAAATGCATTTGTGAGTGTTG
ASV305	ITS2 Extracted ITS2 sequence 55-130 (76 bp)	TACACCGCTCGAGCCGTCTTGGCTCGGTGTTGGGGCGCTAGGGGCTACGGCCCCTAGGCTCCCAAAGGCATTGCGC
ASV306	ITS2 Extracted ITS2 sequence 56-251 (196 bp)	ATTCTCCCATCCCAAGCGGTTTTTATCAAAGAATTGCTAGGCGAAGGGGTTGAGATGGGCGTTGTTATAACTGCTTTTCTTCTCTAGAAAAGCTCGCCCGAAAAACAGCTAACGCCTCTGGGCCACTTTGCATCCGCTTCTCTGAGGGGAGAAGCGGCCAAGCGCGCTCTGATCATCAGGCATAGCATGATACGTC
ASV307	ITS2 Extracted ITS2 sequence 56-250 (195 bp)	AATTCTCAACTCTCTTATACTTTTTTGTAAAAGAGAGCTTGGAATGTGGAGGCTTGCTGGCCACTTTGTGGGGTCAGCTCCTCTGAAATGCATTAGCGGAACCGTTTGCGATCTGCCACAAGTGTGATAAGTTATCTACACTGGCGAGGGGATTGCTCTCTGTAATGTTCAGCTTCTAATTGTCTCTACTTTGTG
ASV308	ITS2 Extracted ITS2 sequence 56-251 (196 bp)	TCACCCCTCAAGCCCCCGGCTTGGTGTTGGACTCAGTCGTCGCTCGCCCGGTGACTGGTCTCGAAGACAGTGACGCCGTCCCAGAGGGAACCGGTACGAGGAGCTTTCTTAATCGAAGCATGTGCCGGGAAGACTTTCGCGGGCGGTGGTCTCTTACACCCACAAATTTTTCAAGTGTTGACCTCGGATCAGGTAG
ASV309	ITS2 Extracted ITS2 sequence 56-193 (138 bp)	CACCCCCCAAGCTTTGCTTGATGTTGGGCGATGCCTAGGCACGCCCCAAACTCCTGGGCGCCTGCCGCCGGCCGCTAGCGTAGCAAATCTACTCGCTCGCGTGTCCGTCGGGAGGCCGCCCCTGAACCTTACTTTCCA
ASV310	ITS2 Extracted ITS2 sequence 56-201 (146 bp)	CTCTCTCAAACCCCCGGGTTTGGTATTGAGTGATACTCTTAGTCGGACTAGGCGTTTGCTTGAAAAGTATTGGCATGGGTAGTACTGGATAGTGCTGTCGACCTCTCAATGTATTAGGTTTATCCAACTCGTTGAATGGTGTGGCG
ASV311	ITS2 Extracted ITS2 sequence 56-213 (158 bp)	CTGCCCTCAAGCACGGCTTGTGTGTTGGGCTCCGTCCCCCCGGGGACGGGTCCGAAAGGCAGCGGCGGCACCGAGTCCGGTCCTCGAGCGTATGGGGCTTTGTCACCCGCTCTGTAGGCCCGGCCGGCGCCAGCCGACAACCAATCATCCTTTTTTCA
ASV312	ITS2 Extracted ITS2 sequence 56-250 (195 bp)	AAACCTCAACCTCCTTGGTTTCTTTCTGGAGACTGAAGGAGGCTTGGACTTTGGAGGCCTTTGCTGGTGTCTCTCACCAGCTCCTCTTAAATGAATTAGCGGGGTCCTCTTTGCCGATCCTCGACACGTGATAAGATGCTTCCGTGTCTCGGTTTCTGGCTCTGTTGCTTTTGGGACCCGCTTCTAACCGTCTGG
ASV313	ITS2 Extracted ITS2 sequence 56-250 (195 bp)	AGTTCTCAACCACATTGAATTTTCTTTTTTTGATGTGGTTTGGTTATTGGAAGCTTGCAGGTCTTATTCTATATAGATCTGCTCTTCTAAAATGCATTAGTGGTATCTGAGCAGAAGCTACTACAGATGTGATAATATGTTTTACATCTTGGTCATGCTGCATGAGCAGATTATACTGCTTCTAAAAGTGAATGT
ASV314	ITS2 Extracted ITS2 sequence 56-218 (163 bp)	TCAACCCTCAAGCCCCGGCTTGGTGTTGGAGGCCCGGCGAGGTTCTGAACCTGGCCGCTCCGAAAGATAACGACGGCGTCCGGCGGACCCCTGGTACAATGGGCTTTCCAAGCACGTATCGGTTGCGGTCCCCGGGGGCTGGTCTATAACCCATTTTTTACAA
ASV315	ITS2 Extracted ITS2 sequence 56-251 (196 bp)	TCCCCCCTCAAACCTCGGGTTTGGTGTTGGACCGACGTTGGTCGTTACCCCGACCAACTGGTCTCAAAGACAATGACGGCGTCCGTGGGACCCTCGATACACCGAGCTTTCTTTTCGAAGCACGTACCGAGTTGCAAGGACCCACGCCCGCCGGTCGCTCTCCCCTTCTCGGAGAAAACGCAAGTTTTTTTCACAA
ASV316	ITS2 Extracted ITS2 sequence 55-251 (197 bp)	TGAATCGTAACGCACTTGGGAGTTGTTATGATTCCCAGGAGGCTGTCTTGAAGTGGGGAGTGCTTGCCTTTTCATGCCTTTCATGTTTGTCTGTCAGGTAGTCGGCTGTTCCTTTGGGGTCCTGTGTGCACCTGTCTTGGGCTTTAGCATGTTGGGTAGGCTTCTCTGAAATGCATTTGTGAGTGTTGCTTGCGACT
ASV317	ITS2 Extracted ITS2 sequence 56-197 (142 bp)	ACACCCATCAAGCCTGGCTTGGTATTGGGCGTCGGGACTTTCTCCCGCGTCCCGATTTCGCCGGCTGGACGACCCGGATCTCAAGCGTTGTGATGAATCTCGCTGGAGGAACGGGCGGCTACGCCGTTAATCTTTCAATCGA
ASV318	ITS2 Extracted ITS2 sequence 53-251 (199 bp)	TTAATATGATCAATAACCTATATTTGTCATGAATGTAGGCGTATTGGAGATTGAGTGTAGAGTGTGTGATGCATTCTGACTTCAAACGCAGTGGGCCCATAAGCTATTCACGGCTTGACTCAATGTTGTAAATAAATCGCCTCATTGGGAACGTGAAGAATTTGGGTAAGCAGATTTTAAGCGATGTTGACCTCAGATC
ASV319	ITS2 Extracted ITS2 sequence 56-220 (165 bp)	CTGCCCTCCAGCCCGGCTGGTGTGTTGGGCCCCGCCCCCCTTCCCGGGGGGGCGGGCCCGAAAGGCAGCGGCGGCACCGCGTCCGGTCCTCGAGCGTATGGGGCTTTGTCACCCGCTCTTGTAGGCCCGGCCGGCGCCAGCCGACCCCCTCAATCTATTTTTTCA
ASV320	ITS2 Extracted ITS2 sequence 56-251 (196 bp)	AATTCTCAACTATACAAGTTTTTATAACATGTATAGCTTGGATCATGGGATTTGCAGGCTTTTACTAGTCAGCTATCCTTAAAAGCATTAGCAGAGCTTTGCCGCTAATCATTGGTGTGATAATTATCTACGCCATTGACGAGTGACATACTGAAGCTTAGCTTCTAATCGTCTTCACAGACAAATTTTGACAATC
ASV321	ITS2 Extracted ITS2 sequence 56-250 (195 bp)	ACACCTCACTACTATAACTTTTTTGTTATAATAGTGGACTTGGAATGCGCTGGTGTCAATCAGCCCTTCTAAAATGGAGTTCTTGCACTGTTGATTTGTTTTAACAGCATGTTGGCCTAATAAGTTTCGGCAGTAATGTTGAAATCACTGGCTTTTTTTGCTTAGAATCTGACAGTCTTGATATACAGAATTTTT
ASV322	ITS2 Extracted ITS2 sequence 56-199 (144 bp)	CAACCCTCAAGCACTGCTTGGTATTGGGCTCCGCTGGTTCCGGCGGGCCTTAAAATCAGTGGCGGCGCCGTTTGGGCTCTGAGCGTAGTAAATATCCTCGCTACAGAGACCAGGCGGTCCTTGTCATCCACCCCAACTTTCTCA
ASV323	ITS2 Extracted ITS2 sequence 56-251 (196 bp)	AATTCTCAACCTTCCAACTTTTATTAGCTTGGTTAGGCTTGGATGTGGGGGTTGCAGGCTTCATCACTGAGGTCGGCTCTCCTTAAATGCATTAGCGGAACTTTTGTGGACCGTCTATTGGTGTGATAATTATCTACGCCGTGGATGTGAAGCAGCTTTATGAAGTTCTGCTTCTAACCGTCCATTGACTTGGACA
ASV324	ITS2 Extracted ITS2 sequence 56-211 (156 bp)	CAACCCTTAAGCCTAGCTTAGTGTTGGGAATCTATCCGCAAGGATAGTTCCTCAAATCCAACGGCGGATCTGTGGTATCCTCCGAGCGTAGTAAATCTTTATCTCGCTTTTGTTAGGTGCCGCTGCTCTCAGCCGCTAAACCCCCCAATTTTTTGT
ASV325	ITS2 Extracted ITS2 sequence 56-251 (196 bp)	ATCTCTCACAGAACCACTTGGTTGCAAAACCGGGTTGGCCTTCTGCTGGTGTTGGAGGATGCGAAGTTTCCGCTCCTCTCAAATGAATTGGTGCGGCCCGCTGCACGGTCAAAATCAACGTTCTAGGTTCAATCCAACTCGTTGCATGGCTGCTGCTCACCATGGTCGCTGCACCTTAAGCCCGCCTCGTGCCTCG
ASV326	ITS2 Extracted ITS2 sequence 55-251 (197 bp)	TGAACCATAACGCACTTGGGAATTGTGCCCAGGAGGCTGTCTTGAAGTGGGGAATGCTTGCCTTTTGTGCTGTCTGTCAGGTAGTCGGCCATTCCTTCGGGGTTCTGCATGCACCTGTCTTGGGCTTTAGCAGGTTGGGTAGGCTTCTCTGAAATGCATTTGTGAGTGTTGCTTGCGACTTGCTCTGTTGGGTTTAT
ASV327	ITS2 Extracted ITS2 sequence 56-250 (195 bp)	AATCTTCAACCTTTTACCGTTTCTTGGAATCGGGAGAAGGCTTGGACTTTGGAGGCCATTGCTGATCTCTTATCTGAAGTCAGCTCCTCTTAAATGAATTAGCGAGGCTGTCCTTTTGCCGATCCTCGGATGTGATAAGTTTGCTTTTACGTCCTCGAGTTTCGGTCAACCCTTTCAAAGCCTTGCTTCTAAACC
ASV328	ITS2 Extracted ITS2 sequence 56-250 (195 bp)	AATTCTCAACTCTCTTATACTATTTTGTACAAGAGAGCTTGGATTGTGGAGGCTTGCTGGCACACTTGTTTGTGGTCAGCTCCTCTGAAATGTATTAGCGGAACCGTTTGCGATCTGCCACAAGTGTGATAAACTATCTACACTGACCGGGGGATTGCTCTGTGTTGTTCAGCTACTAATTGTCTCTATTTTGTG
ASV329	ITS2 Extracted ITS2 sequence 56-218 (163 bp)	CACCACTCAAGCATAGCTTGGTATTGGGCAACCGCCCCCGCCAGTCGAGGACGCGCCTCAAACACCTCGGCGGAGCCTCACCGGCTTTGGGCGTAGTAGAATTTCTAATAACGTCCTTTAACGGAGATGGTTCCTTTGCCGATAGAATCTTTAAATTTTTCTA
ASV330	ITS2 Extracted ITS2 sequence 56-213 (158 bp)	CACCACTCAAGCTATGCTTGGTATTGGGCGTCCGTCCTTCCGGGGGCGCGCCTTAAAGACCTCGGCGAGGCCTCACCGGCTTTAGGCGTAGTAGAATTTATTCGAACGTCTGTCAAAGGAGAGGAACTCTGCCGACTGAAACCTCATATTTTTTTATA
ASV331	ITS2 Extracted ITS2 sequence 56-251 (196 bp)	ATCTCTATCCACCTTATACACTCTGTGTAAGAGTCTATAACATTGGGAGTTGGAGGCTTGCAATGCCCTGCTGGTGTAGGCTATTGCTCCTCTTGAATGTATTAGTGAGGCCCTTGTTGCAACTTTCCTATTGTATCATGCAGCCTTTGGTGTGATAATCATTAATTGTTAATACCCTCTGGCTTAACATGAGTGG
ASV332	ITS2 Extracted ITS2 sequence 56-199 (144 bp)	CACCACTCAAGCCTGGCTTGGTATTGGAGGTCGCGGTCCGCCGCGCCTCCTAATGTCGCCGGCCGAGTCGTCTGTCTCCGAGCGTTGTGAATCTTCAATTCGCTTTCGAGTACAGGCGGCGCGCGCCGTTAAACCTCTTTTTTA
ASV333	ITS2 Extracted ITS2 sequence 56-251 (196 bp)	AATTCTCAACCATGACTTGATTGAGTTGCAAGGCATGGCTTGGAGTTGGGGGTTGCTGGCGCCCAAGGGTGTCGGCTCTCCTGAAATGCATTAGTGATGGGCAAGCAAAGTCTTGGACATGCACGGCCTTATCGACGTGATAATGATCGTCGGGGCTGGAGTGTTTCAGAAGTTGCATGAATGGCCTTTTGCTTCT
ASV334	ITS2 Extracted ITS2 sequence 56-219 (164 bp)	CACCACTCAAGCATTGCTTGGTATTGGGCACCCGTCCGCCGCAAGGCGGGCGTGCCTCGAAGACCTCGGCGTGGCCTAACCGGCTTCGGGCGTAGTAGAGTTAAATCGAACGTCTTATAAGTCTGGATAGGTTCCACTTTGCCGTAAAACCTTTTTATTTTCTA
ASV335	ITS2 Extracted ITS2 sequence 56-209 (154 bp)	CACCACTCAAGCTATGCTTGGTATTGGGTGTCGTCCTTAGTTGGGCGCGCCTTAAAGACCTCGGCGAGGCCACTCCGGCTTTAGGCGTAGTAGAATTTATTCGAACGTCTGTCAAAGGAGAGGAACTCTGCCGATTGAAACCTTTATTTTTCTA
ASV336	ITS2 Extracted ITS2 sequence 56-251 (196 bp)	CATTCTCAAAACCTTCTTGGTTTCTTGACCAGAAAGGCTTTGGACTTTGGAGGCTTTTGCTGGCTTTCCTTTGTTGGAGCCAGCTCCTCTGAAATGGATTAGTAGGGTCTGCTTTTCCGATCCTTGACGTGATAAGATGCTTTCTACGTCTTGGGGGTTCTGCACTCCTGCTTCTAACCGTCTCACAGAAGACAAA
ASV337	ITS2 Extracted ITS2 sequence 56-251 (196 bp)	AAATCTCGAACCGAAGTCTCTCGACCCCGTCGGAGCTCGGTTTCGGACGTTGGGAGCGTGCGGGCGGCGACGTCGGCTCTCCTCAAAGGCATTAGCTGTGGGCGCGAGCCTCGCACGGCACGGCCGCTTCGACGTCGTAATGATCGTCGTGGGCTGGAAGTGCGCGGATCGACATGTTCCCCCATGCTTTGCAACC
ASV338	ITS2 Extracted ITS2 sequence 57-251 (195 bp)	ACACCTCAACTCTCACGGTTTGCCCGTGATGAGCTTGGACTTTGGGGGTTTTGCTGGCCTGTGGTCAGCTCCTCTCAAATGAATCAGCTTTCCAGTGTTTGGTGGCATCGTGGGTGTGATAACTATCTACGCTCGTGGTTGTCTGCCAGGGTGACCTTTGGAAACAGAGGTTTGCTGGAGCTCATAAATGTCTCT
ASV339	ITS2 Extracted ITS2 sequence 56-125 (70 bp)	CAACCCTCAAGCCCTGCTTGGTGTTGGGGTTCTACGGCTGCCGTAGGCCCTGAAAAGAAGTGGCGGGCTC
ASV340	ITS2 Extracted ITS2 sequence 56-140 (85 bp)	CAACCCTCGAACCCCTCCGGGGGGTCGGCGTTGGGGATCGGCCCTTTACGGGGCCGGCCCCGAAATACAGTGGCGGTCTCGCCGC
ASV341	ITS2 Extracted ITS2 sequence 56-251 (196 bp)	AATTCTCAACCTCACCAGTTTTCTGAACTGCGTCGAGGCTTGGATGTGGGGGTTTGTGCAGGCTGCCTCAGCGCGGTCTGCTCCCCTGAAATGCATTAGCGAGTTCATACTGAGCTCCGTCTATTGGTGTGATAATTATCTACGCCGTTGGTCGGGTTCAGACTTGCTTCTAACCGTCCGCAAGGACAACTCTTTG
ASV342	ITS2 Extracted ITS2 sequence 56-251 (196 bp)	AATCTCCCACCCCAAGCGGTTTTTACATGAAACGGCTTGGCGGATGGGGTCTGGATGGGTGCCTCTGCCTGCGCTACCTAGCACAGGCTCGCCCGAAATGCATGAGCGCCTTGAGACACTTTGCATCCGCCTCTCTGTTTGGGAGGAGGCGGCCAAGCAGTGTTTTTCTCCTGGCATGGCATGATACGTCATTTGC
ASV343	ITS2 Extracted ITS2 sequence 56-125 (70 bp)	CAACCCTCAAGCCCTGCTTGGTGTTGGGGTCCTACGGCTGCCGTAGGCCCTGAAAAGAAGTGGCGGGCTC
ASV344	ITS2 Extracted ITS2 sequence 56-251 (196 bp)	GCACTCTCACACCTAACCTTTGGGTTATGTCGTGGAATTGGGATGCGCCGATTTTTATTAGTCGGCACTCCTAAAATGTAGCTCTTGGCTGTTTCCTACTACAGCAGTTTGGCCTAATAGTTTTGACTTTTGTCAAATCTTTGGCTACATTTGCTTCTGGAAGTCAGTCTTGATAATACAGAAAACTCATTTCAAA
ASV345	ITS2 Extracted ITS2 sequence 56-229 (174 bp)	TCACCCCTCAAGCCCCCGGCTTGGTGTTGGACGGTTTGGTCCCGGGACCCCCCTGGACCCCTCCCAAAGACAATGACGGCGGGCTGTCGCACCCCCGGTACACTGAGCATCTTCACGGAGCACGTATCGGTATTCAGGGTCGACGGCACCCGGTCTCACACCTATATCTTTCAA
ASV346	ITS2 Extracted ITS2 sequence 56-250 (195 bp)	ATATCTCAACTCCTAAAGTCTGTAATGGATGATAGGGGCTTGGACTTGGAGGCTTGCCGGCGCTCGTCGGCTCCTCTTAAATGCATTAGCTATGGATCACGATGTGTACGATCTACGGTGTGATATATGTCTACGCTATAGGTCTGCATGCGAGTTACCACCTTCGGGTAGCGCCTCTCAGGGGGCCGTGTGACG
ASV347	ITS2 Extracted ITS2 sequence 56-208 (153 bp)	CACCACTCAAGCCTCGCTTGGTATTGGGCGACGCGGTCCGCCGCGCGCCCCAAATCGACCGGCTGGGTCGATCGTCCCCTCAGCGTTGTGGTTTAACTAAATCGCTAAAGGGTTGTCGGTCGGTTACGCCGTAAAACAAACCAATATTTTAAA
ASV348	ITS2 Extracted ITS2 sequence 56-251 (196 bp)	ATATTCTCAACTCTCTTATGCTGTTTGGCACAGGAGGGCTTGGATGGTGGAGGCTTGCTGGCCACTTGTGTGAGGTCAGCTCCTCTGAAATGCATTAGCGGAACCGTTTGCGATCTGCCACAAGTGTGATAAATTATCTGCACTGACCGGGGGGGATTGCTCTCTGTATTGTTCAGCTTCCAACTGTCTCCATGAG
ASV349	ITS2 Extracted ITS2 sequence 55-152 (98 bp)	TACACCGCTCGAGCCGTCTTGGCTCGGTGTTGGGGCGCTAGGGGCTACGGCCCCTAGGCTCCCAAAGGCATTGCGCGGCCCTAGGAACAGGACCCGAG
ASV350	ITS2 Extracted ITS2 sequence 56-248 (193 bp)	ACATCCTTCAACCTTTCTTGGTTTCTTGACCGGGGAAGGCTTGGACTTTGGGGGTTTTCATTGCTGGCCTCCCTTGAAGCCAGCTCCTCCTAAATGGATTAGTGGGGTCTGCTTTGCCGATCCTTGACGTGATAAGATGTTTCTACGTCTTGGGTTTCGCACTGTCGCTTCAGACCCCGCTTCAAACAGTCTT
ASV351	ITS2 Extracted ITS2 sequence 56-251 (196 bp)	GGAAGGTGACGCTACTTGGGAATTGTGATGATTCCCAGGAAGCTGTCTTGAAGTGGGGAGTGCTTGCCTTTCATGTTATGTGTGTTGTCTGTCAGGTAGTTGAGCCGTTCCTTTTGGGTCCTGGGCTAAAAAAAAAGCATGGTTGGGTAGGCTTCTCTGAAATGCATTTGTGAGTGTCACTTGTGGCTTGCTTTGT
ASV352	ITS2 Extracted ITS2 sequence 56-251 (196 bp)	ACATCTCAAGACCCTGTCTGCTTTTGATAGGTATTGGATTTTGGGGGTTGCAGGCTGTTTCAGATTGCTTGCTCTCCTTGAATGTATTAGTGGAGAAAATCCATTGAACTCCTTTGGTGTGATAACGTCTATCAATGCCAGGAGCAATGTGTCAGTTGTCTCTGCTGTCTAACCTAGCTGTCCATAAACATGGACA
ASV353	ITS2 Extracted ITS2 sequence 56-210 (155 bp)	CTGCCCTCAAGCGCGGCTTGTGTGTTGGGTGCGGTCCCCCCGGGGACCTGCCCGAAAGGCAGCGGCGACGTCCGTTTGGGTCCTCGAGCGTATGGGGCTTTGTCACTCGCTCGGGACGGACCCGCGGGGGTTGGTCACCACCACAATTTTACCAC
ASV354	ITS2 Extracted ITS2 sequence 55-251 (197 bp)	TGAATCGTAACGCACTTGGGAGTTGTTATGATTCCCAGGAGGCTGTCTTGAAGTGGGGAGTGCTTGCCTTTTCATGTTATGTGTGTTGTCTGTCAGGTAGTTGAGCCGTTCCTTTTGGGTCCTGTGCGCACACCCTGTCTGGGCTAAAAAAAAGCATGGTTGGGTAGGCTTCTCTGAAATGCATTTGTGAGTGTCAC
ASV355	ITS2 Extracted ITS2 sequence 56-219 (164 bp)	CACCACTCAAGCATTGCTTGGTATTGGGCACCCGTCCGCCGCAAGGCGGGCGTGCCTCGAAGACCTCGGCGTGGCCTAACCGGCTTCGGGCGTAGTAGAGTTAAATCGAACGTCTTATAAGTCTGGATAGGTTCCACTTTGCCGTAAAACCTTTTTATTTTCTA
ASV356	ITS2 Extracted ITS2 sequence 56-212 (157 bp)	GTACCCTCAAGCTTTGCTTGGTGTTGGGCGTTTTTGTCTTTGGTCGCCCAAAGACTCGCCTTAAAGTGATTGGCAGCCGGCCTTTCTGGTTTCGCAGCGCAGCACATTTTTGCGCTTGCCATCAGCAAGACGGCAATCCATCAAGCCTCCTTCTCAC
ASV357	ITS2 Extracted ITS2 sequence 56-251 (196 bp)	AATCTCAATCCCCCTGGGTTTATGATCTGGGTTGGGACTTGGACTTGGGCGTCCTGCCGGTAACACGGCTCGCCTCAAATGACTTAGTGGATCTCTCAGCATCCGTGGCAGACGTAATAAGTTTCGTCTCGTCCCTTGCCGATGAGTCCGCTCACAACCCGCCATCGCGCACTTTTAGACTCTGACCTCAAATCAG
ASV358	ITS2 Extracted ITS2 sequence 56-205 (150 bp)	GTACCCTCAAGCTCAGCTTGGTGTTGGGTGTTTGTTCCGCCGCGCGCGCGAACTCGCCTCAAATGTATTGGCAGCCGGCAATCTGGTGTGTGAGCGCAGCACAATTTGCGCTCTCCACTGTGTTGCGGCGTCCACAAAGCCTATTTCAAC
ASV359	ITS2 Extracted ITS2 sequence 56-126 (71 bp)	AACACCTCAAATCTCTACTTTATTGTAGAGAATTGGACTTGAGCGATCCCAACTCTCGCAAGAGAGGCGGG
ASV360	ITS2 Extracted ITS2 sequence 56-205 (150 bp)	ACACTCTCAAGCCCTGCTTGGTATTGGAGGCCGCCCTGGGGCGCCCCCGAAACACAGCGGCGACGTAGCCGGACTCCCTGGCGTAGTGACACTTGCTGTCGCCCCGGAGTGGTCGGTCGTGCGTCAGCCGGACAACGCCCAATTTTCTGA
ASV361	ITS2 Extracted ITS2 sequence 56-144 (89 bp)	CAACCCTCAGAACCCCCGTATTTTTGTACGGGGCGTGCTGGTGTTGGGGCCTTCTGCGGCTGCCGCAGGCCCTGAATAACAGTGGCGGG
ASV362	ITS2 Extracted ITS2 sequence 56-140 (85 bp)	CACCACTCAAGCACTGCTTGGTATTGGGCATCGTCCGTCGAAAGACGGGCGTGCCTCGAAGACCTCGGCGGGGCCTAACCCGCTT
ASV363	ITS2 Extracted ITS2 sequence 56-215 (160 bp)	AGACTCAATCCCTCGGGTTTCCGAGGAGATTGGACTTGGGTGTTGCCGCTCTGCCGGCTCGCCTTAAAAGACTTAGCGGGATAGCACCGTAGTCGGCGTAATAAGTTTCGTCGGTGAAGGTTGTGATGACTGCTTACAATCGCCCTCGGGCAATTTTTGA
ASV364	ITS2 Extracted ITS2 sequence 56-125 (70 bp)	CAACCCTCAAGCTTGGCTTGGTATTGGGTGTCACCCAGTTAGGTGTACCTTAAAATCAGTGGCGGGTGCC
ASV365	ITS2 Extracted ITS2 sequence 56-251 (196 bp)	TACTCTCGAACTCGGATCTCGGTCTCGGGTTCGGAAGCTGGGAGCTTGCGGGCGGTTTCCTTCACGGACGTCGGCTCTCCTGAAATGCATTAGCGAGAGGATGGCATGGACCTGGCGTGGCACCTTCGACGTCGTAAGGATCGTCGTGGGGGGCCGTGAGCACAGGCGAGGTGTCATCTCATGCTTCCAGCAAATA
ASV366	ITS2 Extracted ITS2 sequence 58-251 (194 bp)	ATCGTCCCCACCAAACCCAATACCCCCTCGTGGGCATTTGGCAAGAGGATGGGCGGATAATGGTCTCCCGTGCGCACCTGCTCGCGGTTGGCCTAAAAATAAGTTCCTGGCTATCGCAAGCCATGACCAGCGGTGGTTGAAAGACCCTCGATGGGCGTCATGAGCACTTGCATGGCACATTGGGACATCTCGAC
ASV367	ITS2 Extracted ITS2 sequence 56-191 (136 bp)	TGACCAATCACGCAAGTGGTATTGGGGCTTGCCGTCGGCATCCCTTAAAATCAGTGGCAGTGCTATAGGCTCTCAGCGCAGTAATTATTTCGCTCTTGAGTCCTAGACCCACCCGCCAAAACCCCAACTTTCTTAA
ASV368	ITS2 Extracted ITS2 sequence 56-217 (162 bp)	AATCCAATCAAGCCTGGCTTGGTATTGGGCGTCAGGGGTTCCCCGCGCCTCAATTTCACCGGCTGGCCGTCGCCCGTCTTAGCGTTGTGACACATCTCTCGCTACCGATGAGACCGGACCACGCCGTTAAAACTCCATGAATTTCAATCGAAATTTGATTAA
ASV369	ITS2 Extracted ITS2 sequence 56-251 (196 bp)	TCACCCCTCAAGCCCCGTGCTTGGTGTTGGACGGCCGGTCGAGGCACCTCGACCCCTCCTAAAGACAATGACGGCGGCCTGTGGTTCCCCCGGTACACTGAGCTTTTAACTGAGCACGTATCGGACAAGGGCGCCCGGGACCCGGTCCTCTCCTTTGACTAGGAAACTTCTTCAAGGTTGACCTCGGATCAGGTAG
ASV370	ITS2 Extracted ITS2 sequence 56-251 (196 bp)	TCACCCCTCAAGCCCCGTGCTTGGTGTTGGATGGCTCTGGTCGAGTAATGTCGACCCCTCCTAAAGACAATGACGGCGGCCTGTGGAACCCCCGGTACACTGAGCTTTTAACCGAGCACGTAGCGGATGAGGGTGCCCAGGACACGGTCCATCTTCCCTTTAGTGGGAAAGCTTTCAAGGTTGACCTCGGATCAGG
ASV371	ITS2 Extracted ITS2 sequence 56-251 (196 bp)	ACATCTCCAGACCTGTCTGCTTTTGATAGGTATTGGATTTTGGGGGTTGCAGGCTGTTTCAGATTGCTTGCTCTCCTTGAATGTATTAGTGGAGAAAATCCATTGAACTCCTTTGGTGTGATAACATCTATCAATGCCAGGAGCAATGTGTCAGTTGTCTCTGCTGTCTAACCTAGCTGTCCATAAACATGGACAA
ASV372	ITS2 Extracted ITS2 sequence 56-210 (155 bp)	GTACCTTCAAGCTCTGCTTGGTGTTGGGTGTTTTGTCTCGCCTCCGCGCGCAGACTCGCCTTAAAACAATTGGCAGCCGGCGTATTGATTTCGGAGCGCAGTACATCTCGCGCTTTGCACTCATAACGACGACGTCCAAAAGTACATTTTTACAC
ASV373	ITS2 Extracted ITS2 sequence 57-251 (195 bp)	ACACCTCAACTCTCACAGTTTGCTGTGACGAGCTTGGACTCTGGGGGTTTTGCTGGCCACAAGGTTGGCTCCTCTCAAATGAATCAGCTTGCCAGTGTTTGGTGGCGTCACGGGTGTGATAACTGTTTACGCTCGTGGTCGTACACCAGGTGACCTTCAGCGATGGAGGTTTGCTGGAGCTTACAAATGTCTCTC
ASV374	ITS2 Extracted ITS2 sequence 56-187 (132 bp)	CAACCCTCAAGTGCTTTAGTGCTTGGTGTTGGGGCTTCTGCTGCCTGCAGCAGGCCCTGAAAGATAGTGGCGAGGTCGCCGTGACCCTGAGCGTAGTAATTTACACCTCGCTTCTGTGGCTCGCGGCGGGGT
ASV375	ITS2 Extracted ITS2 sequence 56-251 (196 bp)	GCACTCTCACACCTAACCTTTGTGGTTATGTTGTGGAATTGGGATGCGCCGATTTTTACTAGTCGGCACTCCTAAAATGTAGCTCTTGGCTGTTTCCTACTACAGCAGTTTGGCCTAATAGTTTTGACTTTTGTCAAATCTTTGGCTACATTTGCTTCTGGAAATCAGTCTTGATAATACAGAAAACTCATTTCAA
ASV376	ITS2 Extracted ITS2 sequence 56-220 (165 bp)	GTACCCTCAAGCTTTGCTTGGTGTTGGGCGTCTTGTCTTTTGGCTCTTTGCCCAAAGACTCGCCTTAAAACGATTGGCAGCCGGCCTACTGGTTTCGCAGCGCAGCACATTTTTGCGCTTGCAATCAGCAAAAGAGGACGGCACTCCATCAAGACTCCTTCTCAC
ASV377	ITS2 Extracted ITS2 sequence 56-147 (92 bp)	CCATCCCCTCAAGCTCTGCTTGGCTGGTTGGGTCGACGTCCACCCGTGGCCTTGGGCCGGGGGGGGGACGGGCCCGAAAGGCAGTGGCGGGT
ASV378	ITS2 Extracted ITS2 sequence 56-212 (157 bp)	CGACCCTCAAGCCCCGGCTTGGTGATGGGCTCCCGCCGCGTGGCGGGCCCGAAACCCGTAGGGCGCCGCGGCAGCGGGCTCTGAGCGTAGCAAGAGCGCAAGCCTCCCTCGCTCCGGAGACCCCTCCACGGCCGCCTGGAGAACACGCACACCGGCG
ASV379	ITS2 Extracted ITS2 sequence 56-251 (196 bp)	AATTCTCAACCAACCTCTCAGTTCCGAAGGGGCATGGCTTGGAGTTGGGGGTTGCTGGCATGACTGTCAGCTCTCCTTAAATGCATTAGCAATCGAGTTGGGCTAGTCTTTGACGTGCACGGCCTCGGACGTGATAATGATCGTCGTCGCTGGAGCGTCTTTCCTAGACTATGCACATACATAGATAGCTTCTAAT
ASV380	ITS2 Extracted ITS2 sequence 56-199 (144 bp)	CAACCCTCAAGCTCAGCTTGGTATTGAGTCCATGTCAGTAATGGCAGGCTCTAAAATCAGTGGCGGCGCCGCTGGGTCCTAAACGTAGTAATATATCTCGTTACAGGTTCTCAGTGAGCTTCTGCCAAAACCCAAATTTTCTAT
ASV381	ITS2 Extracted ITS2 sequence 56-201 (146 bp)	TACCACTCAAGCCTGGCTTGGTGTTGGGCGACGTCCCCTTTGGGAACGCGCCTTAAAACGCTCGGCGGCGTGGCACCGGCTTTAAGCGTAGCAGAATCTTTCGCTTCGAAAGTCGGGGCCCCGCCTGCCGGAAGACCTACTCACAA
ASV382	ITS2 Extracted ITS2 sequence 58-250 (193 bp)	GTCGTTGCCCCCCCCAAACCCCTAGGGAGTTGGGCGGGACGGATGATGGCCTCCCGTGTGCTCTGTCATGCGGTTGGCATAAAAACAAGTCCTCGGCGACTAACGCCACGACAATCGGTGGTTGTCAAACCTCTGTTGCCTATCGTGTGCGCGTGTCGAGCGAGGGCTCCACAAGCCATGTTGCATCGATTCG
ASV383	ITS2 Extracted ITS2 sequence 56-251 (196 bp)	GATCCATAAGGTGGTATATGCCCTGGTTCGGGTCGCTTATGTGTCCTGAGTTAGCTGGGGGGAGCCGTACAATGGGGATTGTTTGCCATTCGTGTTGTCTGTCAGGTAGTCGGCCGTTCCTTCGGGGTCCAGTGCACACCTGTCTTGGGCTTTAGCACGATGGGTGGGCTTCTCTGAAAAGCATTTGTGGGAGCTG
ASV384	ITS2 Extracted ITS2 sequence 56-204 (149 bp)	TCAACCATCAAGCTCTGCTTGGCATTGGGTATCACCCCCTCATGGGGGTGTACCTCAAACATGTTGGCAGTTACCCTGGGCCTCAAGCGTTAGTAAACTATTAGCTTGGAGGTACCCCCGGCGACTTGCTTCTAGAAACCCACATCTAT
ASV385	ITS2 Extracted ITS2 sequence 56-132 (77 bp)	CAACCCTCAAGCTCTGCTTGGTATTGGGCGCCGTCCTCTCTGCGGACGCGCCTCAAAGACCTCGGCGGTGGCTGTCC
ASV386	ITS2 Extracted ITS2 sequence 56-201 (146 bp)	GTACCTTCAAGCTCTGCTTGGTGTTGGGTGTTTGTCTCCTGTAGACTCGCCTTAAAACAATTGGCAGCCGGCGTATTGATTTCGGAGCGCAGTACATCTCGCGCTTTGCACTCATAACGACGACATCCAAAAGTACATTTTTACAC
ASV387	ITS2 Extracted ITS2 sequence 56-125 (70 bp)	CAACCATCAAGCCCCAGGCTTGTGTTGGGGACCTGCGGCTGCCGCAGGCCCTGAAATCCAGTGGCGGGGT
ASV388	ITS2 Extracted ITS2 sequence 56-251 (196 bp)	AATTCTCAACCCCGATCGGATTTGCTTTCGATTCGGTGGCTTGGACGGTGGAGCGTGCTGGCCCTTTGGGTCGGCTCCTCTCAAATGCATTCGCGGAATTGACTTTGGTCCGTTTCGGTCATCAGTGTGATAATCGTGTTACGCTGTCGGCCAGGATCGAGGTGCCGCATATAATGGTCTTCGGACAACCTCATAT
ASV389	ITS2 Extracted ITS2 sequence 56-203 (148 bp)	CACCACTCAAGCCTCGCTTGGTATTGGGCATCGCGGTCCGCCGCGTGCCTCAAATCGACCGGCTGGGTCTTCTGTCCCCTAAGCGTTGTGGAAACTATTCGCTAAAGGGTGTTCGGGAGGCTACGCCGTAAAACAACCCCATTTCTAA
ASV390	ITS2 Extracted ITS2 sequence 56-251 (196 bp)	TCAACCCTCAAGCCTGGCTTGGTGTTGGATGTGATCGTCGTGATGGACGATCCGTCCCGAAGACAATGACGGCGTCGCGAAGTGCCCCGGTACATGGAGCTTTCACAGCACGTATCGGTGTCGGCTGCGCGACCCGGCCACGGTGGACCAACGTCGTTGGTTCACACTTCCACAAGGTTGACCTCGGATCAGGTAG
ASV391	ITS2 Extracted ITS2 sequence 56-183 (128 bp)	CTCCCTCAAACCGCTGGGTTTGGTGTTGAGCAATACGACTTGGGTTTGCTTGAAAGACGGTAGTGGTAAGGCGGGATCGCTTTGACAATGGCTTAGGTCTAACCAAAAACATTGCTTGCGGCGGTAAC
ASV392	ITS2 Extracted ITS2 sequence 56-251 (196 bp)	CTCTCTCAAACCTCCGGGTTTGGTATTGAGTGATACTCTTAGTTGAACTAGGCGTTTGCTTGAAATGTATTGGCATGAGTGGTACTGGATAGTGCTATATGACTTTCAATGTATTAGGTTTATCCAACTCGTTGAATAGTTTAATGGTATATTTCTCGGTATTCTAGGCTCGGCCTTACAATATAACAAACAAGTT
ASV393	ITS2 Extracted ITS2 sequence 56-251 (196 bp)	ATTCTTCAACCCAATCTTTTCTTGTAATCGATTGGTGTTTGGATTCTGAGCGTTGCTGGCGTTTGCCTAGCTCGTTCGTAATACATTAGCATCCCTAATACAAGTTTGGATTGACTTGGCGTAATAGACTATTCGCTAAGGATTCGGTGGAAACATCGAGCCAACTTCATTAAGGAAGCTCCTAATTTAAAAGTCT
ASV394	ITS2 Extracted ITS2 sequence 56-218 (163 bp)	CACCACTCAAGCATAGCTTGGTATTGGGCAACCGCCCCCGCCAGTCGGGGACGCGCCTCAAAAACCTCGGCGGAGCCTCACCGGCTTTGGGCGTAGTAGAATTTCTAATAACGTCCTTTAACGGAGATGGTTCCATTGCCGACCGAAGCCTTTTATTTTTCTA
ASV395	ITS2 Extracted ITS2 sequence 56-210 (155 bp)	CACCACTCAAGCTATGCTTGGTATTGGGCGTCGTCCTTAGTTGGGCGCGCCTTAAAGACCTCGGCGAGGCCTCACCGGCTTTAGGCGTAGTAGAATTTATTCGAACGTCTGTCAAAGGAGAGGACTTCTGCCGACTGAAACCTTTTATTTTTCTA
ASV396	ITS2 Extracted ITS2 sequence 56-129 (74 bp)	CAACCCTCAAGCCTGGCTTGGTATTGGGCTCCGCCACTCACCTGGCGGGCCTTAAAATCAGTGGCGGTGCCGTC
ASV397	ITS2 Extracted ITS2 sequence 56-201 (146 bp)	CACCACTCAAGCCTGGCTTGGTGTTGGGTGACGTCCATTTTAAGGACGCGCCTCGAAACGCTCGGCGGCGTGGCACCGGCTTTAAGCGTAGCAGAATCTTTCGCTTCGAAAGTCGGGGCCCCGTCTGCCGGAAGACCCATTCGCAA
ASV398	ITS2 Extracted ITS2 sequence 56-251 (196 bp)	TGGTTCTCAATACCATGCTGATTTTATTTGGTGTGGCTTTTGGATATTGGGGGGTTTTGCAGGCTTCTGAAAAGTCAGCTCTCCTGAAATGCATTAGTGGTATCTGAGCAGAGACTACTTACAGGTGTGATAATCATATATCTATGCCTTGGTACGCTGCATAAAACAGATTGCACTGCTTACAACGAGTAGGAAT
ASV399	ITS2 Extracted ITS2 sequence 56-251 (196 bp)	AAACCTCAACCTCCTTGGTTTCTTTCTGGAGACTGAAGGAGGCTTGGACTTTGGAGGCCTTTGCTGGTGTCTCTCACCAGCTCCTCTTAAATGAATTAGCGGGGTCCTCTTTGCTGATCCTCGACACGTGATAAGATGCTTCCGTGTCTCGGTTTCTGGCTCTGTTGCTTTTGGGACCCGCTTCTAACCGTCTGGA
ASV400	ITS2 Extracted ITS2 sequence 56-251 (196 bp)	CACCATTCAATTCTACTTTATTGTTTGAATTGGTTTTGGAAGTTGATAGTCTTTATTGACAATCACTTTTGTAATGAATCCTCGCAGTTGTACTATATGTTCTTAGTTGTAGTATCTACGATCAACTTCAAGTTCATTGTATGACCATTCTTCTTGGTATATTATTAATGAAATAGTATTTCAATTAGTTTGACCT
ASV401	ITS2 Extracted ITS2 sequence 56-250 (195 bp)	ATCTCTCAACCCCTCTTGATTAGCTTCGAGGGGGAGCTTGGATAGTGGGGGTTTGCAGGAAACTTGGACTTTTTAGTCTAGGATTCGAGCTCTCCTGAAATACATTGGCTTGCGGTCGACTTTCGACTTTGCGCGATAAGGCTTTCGGCGTGATAATGATCGCCGTGTGCTGAAGCGCATGACTGTGAAGTTCCG
ASV402	ITS2 Extracted ITS2 sequence 56-218 (163 bp)	ACACCCTCAAGCCTAGCTTGGTGTTGGGCGTCTTGTCCCGCCGTTTCTCGCGCGCGGACTCGCCTCAAAGTCATTGGCGGCGGTCGTGCCGGCCCCTCGCGCAGCACATTTGCGCTTCTCGGAGGCCTGGCGGATCCGCGCTCCAGCAAGACCTTTTTTCATG
ASV403	ITS2 Extracted ITS2 sequence 56-251 (196 bp)	ACTCATCAACCTACCGGTTTCTAGTAAATCGGATTAGTGTTTGGATTCTGAACGCCTGCTGGCCTTTATTGGCGAAGCTCGTTCGTAAATGATTAGCATCTCATATTCGAAAATCGGATTGACTCAGTGTAATAGACTATTCGCTGAGGACGCTCTTTCGGGAGTGGCCGAGTTTTGTAAAGTAGAAGCTTCTAAT
ASV404	ITS2 Extracted ITS2 sequence 56-251 (196 bp)	GCACTCTCACATCTAATCTTTGTTGGTTAAGATTGTGGAATTGGGATGCGCCAATTGTTATTGATTGGCCCTCCTAAAATGTAGCTCTTGACTGTGGACTACTATAGTAGTTTGGCTTAATAGTTTTGGCACTTGTTTGTCAAATCTTTGGCTACATTTACTTTGGTCCATGCAGTCTTGATATACAGAAAACTCA
ASV405	ITS2 Extracted ITS2 sequence 56-157 (102 bp)	AATTCTCAACCAATCTCTCTTGATTAATCTTTAATCTTCAAGGGGAGCTATGGCTTGGAGTTGGGAGTTGCTGGCATGACTGTCAGCTCTCCTTAAATTTAT
ASV406	ITS2 Extracted ITS2 sequence 56-249 (194 bp)	ATATTCTCAACTCTCTTATGCTGTTTGGCACAGGAGGGCTTGGATGGTGGAGGCTTGCTGGCCACTTGTGTGAGGTCAGCTCCTCTGAAATGCATTAGCGGAACCGTTTGCGATCTGCCACAAGTGTGATAAATTATCTGCACTGACCGGGGGGATTGCTCTCTGTATTGTTCAGCTTCCAACTGTCTCCATGA
ASV407	ITS2 Extracted ITS2 sequence 56-219 (164 bp)	TCCTCCCTCAAACCTCGTGTTTGGTGTTGGACCGCGTTGGCCGAGCGACCAACTGGTCTCAAAGACAATGACGGCGTCCGTGGGACCCTCGGTGCAACGAGCTTCTAAGGAGCACGCGTCGAGTTTCAAGGACCCTCCGGGCCGGTCTTACCTCTATCTTCTCA
ASV408	ITS2 Extracted ITS2 sequence 56-195 (140 bp)	CACCACTCAAGCCTGGCTTGGTATTGGGCGACGGGGAGACCCGCGCCCGAATGTCTCCGGCGGGACGGCTCCGATCTCAGCGTTGTGGCACAAGTCCGCTGGCGAGAGGGGGCGGCCCGGCCGTTAAACACTCCATCAAA
ASV409	ITS2 Extracted ITS2 sequence 56-200 (145 bp)	AAACCTTCAAGCTCTGCTTGGTTTTGGGCGCAGGTCCCCGGAGACCCGCCCGTAACTCGTTGGTGGTCGGTACCGGCTCTAAGCGTAGCAGAAACCTTTCGCTTCTGACGCCGGTGCCCTCCCGCCCGGAAAGCCTCCTTCTAAA
ASV410	ITS2 Extracted ITS2 sequence 56-140 (85 bp)	GAACCCTCGAACCCCTCCGGGGGGTCGGCGTTGGGGATCGGCCCTTTACGGGGCCGGCCCCGAAATACAGTGGCGGTCTCGCCGC
ASV411	ITS2 Extracted ITS2 sequence 56-218 (163 bp)	TCAACCATCAAGCCTGGCTTGTCGTTGGACCCTTTTTACCGCTGAAATATGTGGTAGGTCCGAAAGATAATGACGGCGTCGTGTTTGACCCTAGATGCAACGAGCTTTTTATAGCACGCATTGAAGTGGTCGACCGACCCGGTCTTTAACCATCATTTTCTAA
ASV412	ITS2 Extracted ITS2 sequence 56-141 (86 bp)	CAACCCCTCAAGCTTCAGCTTGGTGTTGGGCTGTGCCACTGCCCTCTTGCGGGCGCCGGCAGGCCTTAAAATCAGTGGCGGTGCCC
ASV413	ITS2 Extracted ITS2 sequence 56-251 (196 bp)	ATACTCTCAAACTTAACCTTTTTTCTTTATTGAAGGAAGGTTATAGTTTGGACTTGGATGTTGCTGCTATTTTATTATAGCAGCTCGTCTCGAAATGCATTAGCTGGTCCGCCGCGGTTTATAACTCATAATGGTGTGATAAGAAACAATTTCATTGTTGATTTGTAGCGCTGTTGTTATAAACTTGAAGTGACTG
ASV414	ITS2 Extracted ITS2 sequence 56-207 (152 bp)	CAACCCTTAAGCCTAGCTTAGTGTTGGGAATCTACTGTATTGTAGTTCCTGAAATACAACGGCGGATCTGTAATATCCTCTGAGCGTAGTAATTTTTTTCTCGCTTTGGTTAGGTGTTGCAGCTCTCAGCCGCTAAACCCCCCAATTTTAAT
ASV415	ITS2 Extracted ITS2 sequence 56-143 (88 bp)	CAACCCTCAGGCCCCCAGTGCCTGGCGTTGGGGATCGGCCGACGGCAGCCTTCGGGCTCGCCTGGCCGTCCCCGAAATCTAGTGGCGG
ASV416	ITS2 Extracted ITS2 sequence 56-251 (196 bp)	TGGTTCTCAATACCATGCTGATTTTATTTGGTGTGGCTTTGGATATTGGGGGGTTTTGCAGGCTTCTGAAAAGTCAGCTCTCCTGAAATGCATTAGTGGTATCTGAGCAGAGACTACTTACAGGTGTGATAATCATATATCTATGCCTTGGTACGCTGCATAAAACAGATTGCACTGCTTACAACAAGTAGGAATT
ASV417	ITS2 Extracted ITS2 sequence 56-251 (196 bp)	GAACCGTAAAGTACCTGGGAGAATTGTGCCTAGAAGGCTGTCTTGAAGTGGAGAGTGCTTGCCTTTTGTATTGTCTGTCAGGTGGTTGGCCATTCCTGTGCATGCCTGTCTTGGGCTTTAGCATGTTGGATAGACTTCTCTGAAATGCATTTGTGAGCATTGCAAGTGACTTGCTTTGTTGGGTTTAATAGGTGTC
ASV418	ITS2 Extracted ITS2 sequence 56-219 (164 bp)	CACCACTCAAGCCTCGCTTGGTATTGGGAGCCCTGCGGCTGTTTACAAGCTGCACTCCTTGAATTCTTCCGGCTGGTGTTTACTCTTACCCTTTGCGTTGTGGAAACATATTCTCGCTCATGGGTTCGGTGGACATCTTTGGCCGTTAAACTTCCATTTCACAA
ASV419	ITS2 Extracted ITS2 sequence 56-251 (196 bp)	ATCTCTCAACCCCTCTCGATTAGCTTCGAGGGGGAGCTTGGATAGTGGGGGTTTGCAGGAAACTTGGACTTTTCATAGTCTAGGATTCGAGCTCTCCTGAAATACATTGGCTTGCGGTCGACTTTCGACTTTGCGCGATAAGGCTTTCGGCGTGATAATGATCGCCGTGTGCTGAAGCGCATGACTGTGAAGTTCC
ASV420	ITS2 Extracted ITS2 sequence 56-251 (196 bp)	ATGCCCTCAACCTTCTTGGTTTCTCGACCGGGAAGGCTTGGACTTTGGAGGTTATCATTGCCGGCCTCTTTTGAAGCCGGCTCCTCCTAAATGAATTAGTGGGGTCCGCTTTGCCGATCCTTGACGTGATAAGTATGCTTCTACGTCTTGGGTTTTGCATTGTCGCACCGGAACCTGCTTCCAACCGTCTTCTGTT
ASV421	ITS2 Extracted ITS2 sequence 56-204 (149 bp)	TCAACCATCAAGCTCTGCTTGGCATTGGGTATCACCCCCTCACGGGGATGTACCTCAAACATGTTGGCAGTTACCCTGGGCCTCAAGCGTTAGTAAACTATTAGCTTGGAGGTACCCCCGGCGACTTGCTTCTAGAAACCCACATCTAT
ASV422	ITS2 Extracted ITS2 sequence 56-201 (146 bp)	CACCACTCAAGCCTGGCTTGGTGTTGGGTGACGTCCATTTTAAGGACGCGCCTCGAAACGCTCGGCGGCGTGGCACCGGCTTTAAGCGTAGCAGAATCTTTCGCTTCGAAAGTCGGGGCCCCGTCTGCCGGAAGACCCATTCGCAA
ASV423	ITS2 Extracted ITS2 sequence 56-204 (149 bp)	TCAACCATCAAGCCCAGCTTGGTATTGGGTTTCGCCCTTAACCGGGCGGTCCCTAAAGGTCTAGGCGACGGCATCAAACCTCAAGCGTAGTACAATCATCAGCTTTTTAGGTTTTGGTGCTGTCACGCCCACAGTACACAACACCTCAA
ASV424	ITS2 Extracted ITS2 sequence 56-250 (195 bp)	AATTCTCAACCTTTTCAATCTTTTATTGGTTGAATTAGGTTTGGATGTGGGAGTCTTTTGCTGGCTTCTTTAAAAGAGGTCGGCTCTCCTTAAATTTATTAGCAGGACCTTTGTGGCCCTCTCAGCTTTAGTGTGATAATTATCTACGCTATTTGCTGAAGGCAACTCATAAAATAGGGTTTCCAGCTTCTAATC
ASV425	ITS2 Extracted ITS2 sequence 56-220 (165 bp)	TCCTCCCTCAAACCTCGTGTTTGGTGTTGGACCGCGTTGGTCGAGCGACCAACTGGTCTCAAAGACAATGACGGCGTCCGTGGGACCCTCGGTGCAACGAGCTTCTAAGGAGCACGCGTCGAGTTTCAAGGACCCTCCGGGCCGGTCTTGACCTATATCTTCTCA
ASV426	ITS2 Extracted ITS2 sequence 56-207 (152 bp)	ACACCCTCAAGCTCTGCTTGGTGTTGGGCGTCTGTCCCGCCTACGTGTGCGGACTCGCCCCAAATTCATTGGCAGCGGTCCTTGCCTCCTCTCGCGCAGCACATTGCGCTTCTCGAGGTGCGCGGCCCGCGTCCACGAAGCAACATTACCGT
ASV427	ITS2 Extracted ITS2 sequence 56-250 (195 bp)	AATTCTCAACTCTCTTGTACTATTTTGTACAAGAGAGCTTGGATTGTGGAGGCTTGCTGGCCACTTTGTTGGGGTCAGCTCCTCTAAAATACATTAGCGGAACCGTTTGCGATCTGCCACAAGTGTGATAAACTATCTACACTGACCGGGGGATTGCTCTGTGTTGTTCAGCTACTAATTGTCTTTATTTGATAA
ASV428	ITS2 Extracted ITS2 sequence 56-251 (196 bp)	ATTCCTCAACCTTCTGCTTTTCTTTTGATAGCAGAAGGCTTGGACTTTGGAGGTTCTTGCTGGCCCCTCTCTTCAGAGGCCAGCTCCTCTTAAATGGATTAGCAGGGTCTGCCTTTGGGCCGATCCTCGACGTGATAAGCTGTTTCTACGTCTTGGATTTGGCTCTGCCTCTCTTTTGAGAGACCTGCTTCCAATC
ASV429	ITS2 Extracted ITS2 sequence 56-251 (196 bp)	CAACCCTCAAGCCCCAGTGGCCTGGTGTTGGGGACCGGCGACCTCGCCCGGGGGAACACCCCCGGCGCGTCCGCCGCCCCCGAAATGAATTGGCGGCCCCGTCGCGGCCTCCTCTGCGTAGTAGCACAACCTCGCAGCGGGAGCGCGACGCGGCCACTGCCGTAAAACGCCCAACTTTTTTTAGAGTTGACCTCGG
ASV430	ITS2 Extracted ITS2 sequence 56-179 (124 bp)	CAACCCTTAAGCCTAGCTTAGTGTTGGGAGCCTATCCGCAAGGATAGCTCCTCAAATCCAACGGCGGATCTGTGGTATCCTCTGAGCGTAGTAAAACTTTTATCTCGCTTTTGTCAGGTGCCGC
ASV431	ITS2 Extracted ITS2 sequence 56-201 (146 bp)	GATCCATAAGGTGGTATATGCCCTGGTTCGGGTCGCTTATGTGTCCTGAGTTAGCTGGGGGGAGCCGTACAATGGGGATTGTTTGCCTTTCGTGTTGTCTGTCAGGTAGTCGGCCGTTCCTTCGGGGTCCAGTGCACACCTGTCTT
ASV432	ITS2 Extracted ITS2 sequence 56-219 (164 bp)	CACACCTCTGCTCCGGCTTTTGCTGAGCAGGTTGTGGGCGCGCCCTTCGCAAGATCGGCGCCCCTAACGTAGTACGCTTGCGGGCTCCCACACAGATGTCAACGTAGTAAACTAAACGCTCGGTGTAATCTTTGTGGAGGCTCTGCCTGAACAAATCTTCTTGA
ASV433	ITS2 Extracted ITS2 sequence 56-251 (196 bp)	GAACTATAACGCACTTGGGGATTGTGCCCAGGAGGCTGTCTGTCAGGTAGTCGGCTGTTCCTTTGGGGTCCTGTGTGCACCTGTCTTGGGCTTTAGCATGTTGGGTAGGCTTCTCTGAAATGCATTTGTGAGTGTTGCTTGCGACTTGCTCTGTTGGGTTTATAGGCGTCATAGTTTTATGCGCCGGTGAGTCTGC
ASV434	ITS2 Extracted ITS2 sequence 56-251 (196 bp)	TCACCCCTCAAGCCCCGTGCTTGGTGTTGGACGGGTTGGTCGGGGGCTTCCCTCGACCCCTCCTAAAGACAATGACGGCGGCCTGTGGCTCCCCCGGTACACTGAGCTTCTTAACCGAGCACGTACCGGACGAGGGCGCCCGGGCCCCGGTCTTCTCCTTTCACTAGGAATTTTTTTTCAAGGTTGACCTCGGATC
ASV435	ITS2 Extracted ITS2 sequence 56-211 (156 bp)	CAACCCTTAAGCCTAGCTTAGTATTGGGAGTCTAGCCGCAAGGTTAGTTCCTCAAATCCAACGGCGGATCTGTGGTATCCTCTGAGCGTAGTAAATTTTTATCTCGCTTTTGTTAGGTGCCGCTGCTCTCAGCCGCTAAACCCCCCAATTTTTTGT
ASV436	ITS2 Extracted ITS2 sequence 56-251 (196 bp)	TCACCCCTCAAGCCCTGTGCTTGGTGTTGGATGGCTTTGGTTGAGTCGCCTCGACCCCTCCTAAAGACAATGACGGCGGCCTGTGGAACCCCCGGTACACTGAGCTTATAACCGAGCACGTATCGGACGAGGGTGCCCAGGACCCGGTCCTTCTTCCCTTTGCTGGGAAAGCTTTTTAAGGTTGACCTCGGATCAG
ASV437	ITS2 Extracted ITS2 sequence 56-214 (159 bp)	CACCCCTCAAGCTCTGCTTGGTGTTGGGCCTCTGTCGCGCCTCTCCGGCGCCGACTGGCCTCAAATGCAACGGCGGCCTCCTCGCCCGGCCCTCTCAGCGCAGCAGTTCGCGCCCTGGAGAGCCGGCAGGAGCGTCGCTTCCACCGAAGAACCCCCCAA
ASV438	ITS2 Extracted ITS2 sequence 56-251 (196 bp)	AATTCTCAATCTTTTCGACTTTATTGTTGATAGATTGGATGTGAGGGTTTATGTGGGGACATGTTCTTCACTCCCTTGAAATATATTAGCTGGAATGCCTTGGCAAATCCAACTATTAGTGTGATAAAATATCAGTACTGTAGTTGTTGCAACAAGGGAATCTGCTTACTAGTCGTGTTAAAAAAAAACACAATCT
ASV439	ITS2 Extracted ITS2 sequence 56-126 (71 bp)	CAACCCACCAAGCCCTGCTTGTGCTGGGGCCCTGCGGCTGCCCGCAGGCCCTGAAAACCAGTGGCGGGCTC
ASV440	ITS2 Extracted ITS2 sequence 57-251 (195 bp)	ACACCTCAACTCTCATGGTTCGCCGTGATGAGCTTGGACTTTGGGGGTTTTTGCTGGCCTGTGGTCAGCTCCTCTCAAACGAATCAGCTTGCCAGTGTTTGGTGGCATCACGGGTGTGATAACTATCTACACTCGTGGTCGTCCACCAGGCAACCTTTGGCAACAGAGGTTCACTGGAGCTTATAAACGTCTCTC
ASV441	ITS2 Extracted ITS2 sequence 56-212 (157 bp)	TCAACCTATCAAGCTTGGCTTGTTGTTGGGCCCTCTGTCACCTGGTGATAGGTCCAAAAGATAATGACCGGTGTCACAAAGACTCTACATGCAACGAGCTTATAACAGCACGCATCTGGTAGTTGTGTGACCCAGTTCTCACCCTTCTATTTCTCAA
ASV442	ITS2 Extracted ITS2 sequence 56-209 (154 bp)	GTACCCTCCAGCCCTGCTGGGTGTTGGGCGTTTTGTTCCGCTACACGCGTGAACTCGCCTCAAATGCATTGGCAGCCAGCCGTCCCGCGTGGGAGCGCAGCACATTTTGCGCTCTCCGCTGGGTGCGGCGGCGTCCACAAGCCTATACCTTTAC
ASV443	ITS2 Extracted ITS2 sequence 56-130 (75 bp)	TCCACCTCTCAAGCCTGGCTTGTTATTGGGCTCTTGATCGTTTATCCCGATCGGCCTGAAAGATAATGGCGGTTT
ASV444	ITS2 Extracted ITS2 sequence 56-201 (146 bp)	CACCACTCAAGCCTGACTTGGTGTTGGGTGACGTTCATTTTAAGGACGCGCCTCGAAACGCTCGGCGGCGTGGCACCGGCTTTAAGCGTAGCAGAATCTTTCGCTTCGAAAGTCGGGGCCCCGTCTGCCGGAAGACCTATTCGCAA
ASV445	ITS2 Extracted ITS2 sequence 56-214 (159 bp)	TCAACCATCAAGCCTGGCTTGTTGTTGGACTCTTACTGCTGAAATATGTGGTAGGTCCGAAAAATAATGACGGTGTCGTGTTTTGACTCTAAATGCAACGAGCTTTTATAGCACGCATTGAAGTGGTCAACCGGCCTGGTCTTAACCATCATTTTCTAA
ASV446	ITS2 Extracted ITS2 sequence 56-251 (196 bp)	AGTTCTCAACCTTCTCCATTTTCTTTCTTGACTTGGGGAAAGGCTTGGATTTTGGAGGCTTTTGCTGGACTCTCTTGATTGAGATCGGCTCCTCTTAAATGGATTAGTAGGATCCCTTTTTCGCTGGTCCTTGACGTGATAAGGCTTTTCTACGTCTGGATCTTGGCTTATGAGGCCTGCTTCTAATCGTCTCTCG
ASV447	ITS2 Extracted ITS2 sequence 56-215 (160 bp)	TCACCATATCAAGCTTGGCTTGTTGTTGGGCCCTTTGTCACCTGGTGACAGGTCCAAAAGACAATAGCCGGTGTCATACAGACTCTATATGCAACGAGCTGATAACAGCACGCATCTGGTGGTCGTGTGGCCCGGTTTTCACTTTAAATATATTTCTCAA
ASV448	ITS2 Extracted ITS2 sequence 56-199 (144 bp)	CACCACTCAAGCCTCGCTTGGTATTGGGGGCCGCGAGCGATCGCGCCCCTTAAAGTCACCGGCTGAGCCGTCCGTCTCCAAGCGTTGTGGCAAACTATTCCGCGAGCGAGACCCGGGCGACCCGGCCGTTAAACCCCCATCACA
ASV449	ITS2 Extracted ITS2 sequence 56-127 (72 bp)	CAACCCTCAAGCTCTGCTTGGTGTTGGGGCCCTACGTCTGACGTAGGCCCTGAAAGGAAGTGGCGGGCTCGC
ASV450	ITS2 Extracted ITS2 sequence 56-144 (89 bp)	CGCCCCTCAAGTCCCCTGTGGACTTGGTGTTGGGGATCGGCGAGGCTGGTTTTCCAGCACAGCCGTCCCTTAAATGAATTGGCGGTCTC
ASV451	ITS2 Extracted ITS2 sequence 56-200 (145 bp)	CAACCCTCAAGCCCAGCTTGGTGTTGGGAGCCACCCCAGCGGTGCTCCTCAAAGGCAGTGGCGGCGCCTCTCGGCTCTAAGCGTAGTAATTCATTCTCGCTCTGGGGACCTAGAGGTGGCTTGCCAGCAATCCCAAATCTATCAA
ASV452	ITS2 Extracted ITS2 sequence 56-250 (195 bp)	GAACTATAACGCACTTGGGGATTGTGCCCAGGAGGCTGTCTGTCAGGTAGTCGGCTGTTCCTTTGGGGTCCTGTGTGCACCTGTCTTGGGCTTTAGCATGTTGGGTAGGCTTCTCTGAAATGCATTTGTGAGTGTTGCTTGTGACTTGCTCTGTTGGGTTTATAGGCGTCATAGTTTTATGCGCCGGTGAGTCTG
ASV453	ITS2 Extracted ITS2 sequence 56-203 (148 bp)	CACCAATCGAGCCTGGCTCGGTATTGGGCGTCGCGGGTTTCGACCCGCGCGCCTTAAAGTCTCACCGGCTGAGCGGCGTCGTCTCTAAGCGTTGTGGAAACTATTCGCGGAGGGACGGGGCGGCGTGGCCGTTAAATACCCCATCAAA
ASV454	ITS2 Extracted ITS2 sequence 56-251 (196 bp)	AATCTCAATCTAATATGTTTTCTGAACATGTTAGGCTTGGACTTGGGTGTCTGCCAGCAATGGCTCACCTCAAATGACTTAGTGGAACATCCCACATCAGTGTTAGACGTAATAAGTTTCGTCTCTCCTTGTGGTGATGACTGCTCAAAACCTGCCATCGCGCACCTTTTGACTTTGACCTGAAATCAGGTAGGGC
ASV455	ITS2 Extracted ITS2 sequence 56-251 (196 bp)	AAACCTCGGATCGACGCTTCGACCCCGTCGGAGCTCGGTCTGGACTTGTGGGAGTCTGCGGGCGAAGCGTGACTTCGTCGGCTCTCCTCAAAAGCATTAGCCGTGGGTGGCGAGCCTGGCATGGCACGGCCCCTTCGACGTCGTAATGATCGTCGTGGGCTGGAAGCGTGTACGGCTCGACGGACCCATGCTTCGC
ASV456	ITS2 Extracted ITS2 sequence 57-251 (195 bp)	ACACCTCAACTCTCATGGCTTGCCATGATGAGCTTGGACTTTGGGGGTCTTGCTGGCCTACAGCCAGCTCCTCTCAAATGAATCAGCTTGCCAGTGTTTGGTGGGATCGCAGGTGTGATAAGTATCTACGCTTGTGGCTTTCCACCAGGTAACCTTCAGTGATGGAGGTTCGCTGGAGCTCATAAACGTCCCTCC
ASV457	ITS2 Extracted ITS2 sequence 56-251 (196 bp)	AAATCTCAACCTCCTCGGTTTCTTTTGGACATTGAAGGAGGCTTGGACTTTGGAGGGCTTTGCTGGACTTGAAAGGCCAGCTCCTCTCAAATAAATTAGCGAGGTCCCCTTTGCCGATCCTCGACGTGTGATAAGATACTTCCACGTCTTGGTCTTTGGCTCTGTCGCCTCTTGGGACCTGCTTCCAATTGTCTCT
ASV458	ITS2 Extracted ITS2 sequence 56-251 (196 bp)	AATATTATCAAGCAACAGCTTGGTTTTGGGCTTTTCCATCCATTTATATATAAAGGGATGGGCCTAAAAATTAGTGGCGATACTATTTTCTAGCTTCAAAACGTAGTAAAATTAAATTTTCTCGTTTTAGGTTCAGTTAAAATGTATCTGTCAAAAAAAACCCCCTAATTTTTTTTTAAAAATTGACCTCGAATCA
ASV460	ITS2 Extracted ITS2 sequence 56-214 (159 bp)	GTACCCTCAAGCTTTGCTTGGTGTTGGGCGTTTTTGTCTTTGGTTTGCCAAAGACTCGCCTTAAAACGATTGGCAGCCGGCCTCCTGGTTACGCAGCGCAGCACATTTTTGCGCTTGCAATCAGCAAGAGGGCGGCACTCCATCAAGACTCCTTCTCAC
ASV461	ITS2 Extracted ITS2 sequence 56-210 (155 bp)	CACCACTCAAGCTATGCTTGGTATTGGGTGCCGTCCTTAGTTGGGCGCGCCTTAAAGACCTCGGCGAGGCCACTCCGGCTTTAGGCGTAGTAGAATTTATTCGAACGTCTGTCAAAGGAGAGGAACTCTGCCGATTGAAACCTTTTATTTTTCTA
ASV462	ITS2 Extracted ITS2 sequence 56-125 (70 bp)	CAACCCTCAAGCTCTGCTTGGTGTTGGGGCACAGCCTTTCATAGGGCTGGCCCTGAAATCCAGTGGCGGG
ASV463	ITS2 Extracted ITS2 sequence 56-144 (89 bp)	CCACCCTCATGCGCCCCGTTTGCGCGTGGTGTTGGGGCTCTGCTCTCCCGCCCTGGCGCGGGAGAGGCCCTGAAAGCGAGTGGCGGGCC
ASV464	ITS2 Extracted ITS2 sequence 56-125 (70 bp)	TCTCTCAACCCTCTGGGTTGGTCTTGCCCGCCAAACATCATCTCGGCCCTAGAATAAGTTTTAGGACCCG
ASV465	ITS2 Extracted ITS2 sequence 56-251 (196 bp)	CCTTCTCAAACATTCTGTTTGGTAGTGAGTGATACTCTTTGGAGTTAACTTGAAATTGCTGGCCTTTTCATTGGATGTTTTTTTTTTCCAAAGAGAGGTTTCTCTGCGTGCTTGAGGTATAATGCAAGTACGGTCGTTTTAGGTTTTACCAACTGCGGCTAATCTTTTTTATACTGAGCGTATTGGAACGTTATCG
ASV466	ITS2 Extracted ITS2 sequence 56-250 (195 bp)	AATTCTCAAACCTCTCATCGCTTTTGTGATGAAGGGGATATTGGATCTGGAAGCTGCGGGCCTCTCTGGCGAGGTTGGCTCTTCTCAAATGCATTAGCAAGGACCTTATCTTCTGTTTGCCTTGGTGTGATAGTTATCTACGCCATTGGCTCGAGATATAATGTGGTCTGGCTCTCCAATGGTCGTCCCTCGACG
ASV467	ITS2 Extracted ITS2 sequence 56-251 (196 bp)	CAAACCCTCTATCCAACTTTTGTTGAATAGGATGACTGAGAGTCTCTTGATCTTTCGATCTCGAACCTCTTGAAATGTACAAAGGCCTGATCTTGTTTGAATGCCTGAACTTTTTTTAATATAAAGAGAAGCTCTTGCGATAAACTGTGCTGGGGCCTCCCAAATAACACTCTTTTAAATTTGATCTGAAATCAGG
ASV468	ITS2 Extracted ITS2 sequence 56-250 (195 bp)	AATCTCCCACCCCAAGCGGTTTTTAAATGAAACGGCTTGGCGGATGGGGTCTGGATGGGTGCCTCTGCCTGCGCTACCTAGCACAGGCTCGCCCGAAATGCATGAGCGCCTTGAGACACTTTGCATCCGCCTCTCTGTTTGGGAGGAGGCGGCCAAGCAGTGTTTTTCTCCTGGCATGGCATGATACGTCATTTG
ASV469	ITS2 Extracted ITS2 sequence 57-251 (195 bp)	ACACCTCAACCCTCATGGTTTGCCATGATGGGCTTGGACTTTGGAGGTTTTGCGGGCTTGTTGCCGGCTCCTCTCAAACGAATTAGCTTACCAGTGTATGGTGGCATCACAGGTGTGATAACTATCTGCGCTTGTGGCTGTCTGCCAGGTAACCTTCAACCTTGGAGGTTCGCTGGGGCTTACAAACGTCTCTCC
ASV470	ITS2 Extracted ITS2 sequence 56-189 (134 bp)	ATATCCTAAGACCTTTGTCTTGAGTTGATATTGCCTGTATGAAGGCTTATCTAAATAAATTGGCATCTACTTTTGGCCTGAATTGCAGCGAAATGTAATGACAGTCAAAAGAAGATCGCCTATTATCTTCGAAA
ASV471	ITS2 Extracted ITS2 sequence 56-181 (126 bp)	ACACCCCTCGACTCCGGTCGGTGTTGGGCCAGCCCGCGCGGCGGCTCGAAACAGAATGGCCCGGGCGCCGTCGGTCACGGTTGACAGGAGTCTCCCGCGACGGCCGTCTGGTGCAGAAGCACGCAC
ASV472	ITS2 Extracted ITS2 sequence 56-250 (195 bp)	GATCCATAAGGTGGTATATGCCCTGGTTCGGGTCGCTTATGTGTCCTGAGTTAGCTGGGGGGAGCCGTACAATGGGGATTGTTTGCCTTTCGTGTTGTCTGTCAGGTAGTCGGCCGTTCCTTCGGGGTCCAGTGCACACCTGTCTTGGGCTTTAGCACGATGGGTGGGCTTCTCTGAAAAGCATTTGTGGGAGCT
ASV473	ITS2 Extracted ITS2 sequence 56-138 (83 bp)	CACCACTCAAGCACTGCTTGGTATTGGGCACCCGTCCGCCGAAAGGCGGGCGTGCCTCGAAGACCTCGGCGGGGCCTAACCGG
ASV474	ITS2 Extracted ITS2 sequence 56-198 (143 bp)	CACCACTCAAGCCTGGCTTGGTATTGGGCGCCGCGGTGTTCCGCGCGCCTCAAAGTCTCCGGCTGAGCTGTCCGTCTCCAAGCGTTGTGATTTCATTAATCGCTTCGGGGTGCGGGCGGCCGCGGCCGTTAAATCTTTCACAA
ASV475	ITS2 Extracted ITS2 sequence 56-251 (196 bp)	ATCTCTCACAGAACCACTTGGTTGCGAAACCGGGTTGGCCTTCTGCTGGTGTTGGAGGATGCGAAGTTTTCCGCTCCTCTTAAATGAATTGGTGCGGCCCGCTGCACGGTCAAAATCAACGTTCTAGGTTCAATCCAACTCGTTGCATGGCTGCTGCTCACCATGGTCGCTGCACCTTAAGCCCGCCTCGTGCCTC
ASV476	ITS2 Extracted ITS2 sequence 56-192 (137 bp)	CAACCCTCAGGCCACGCCTGGTGATGGGGACCGCCGTGGCGGCCCTGAAAGCTAGCGGCAGGCTCTGCTACAACCCGAGCGCAGTAGTGTTCTCGCTTAGGGGGAAGCAGGTGCCTAGCCCTCTACATTTTACCCAT
ASV478	ITS2 Extracted ITS2 sequence 56-148 (93 bp)	CAACCCTCAGAACCCCCCGTATTTTGTACGGGGTGTGCTGGTGTTGGGGCCTTCTGCGGCTGCCGCAGGTCCTGAATAACAGTGGCGGGCTCC
ASV479	ITS2 Extracted ITS2 sequence 56-251 (196 bp)	GCACTCTCACACCTAACCTTTGGGTTTATGGCGTGGAATTGGAATGCGCCGACTGTCATGGTTGGCCCTTCTAAAATGTAGTTCTTGGCTGTCACCTAATACAGCAGTTTGGCCTAATAGTTTTGGCATTCATTGTCAAATCTTTGGCTAACATTTGCTCCAGGAGTCAGTCTTGATAATACAGAAAACTCATTCA
ASV480	ITS2 Extracted ITS2 sequence 56-251 (196 bp)	AAACCTCGAACCAAAGTCCTTCGATCCGTCGGAGCTTTGTTTTCGGACCATGGGAGCATGCGGGCGGCGACGTCGGCTCTCCTCAAAAGCATTAGCTGTGGGCGGCGAGCCTTGCGTGACACACGGCCTTGTTCGACGTCGTAATGATCGTCGTGGGCTGGAGGCGCGTGGATCGACCAGTCTCATGCTTCGCAAC
ASV481	ITS2 Extracted ITS2 sequence 56-224 (169 bp)	TCAACCATCAAGCCTGGCTTGTCGTTGGGCCCTTTTGTCGGTGAGATACCCGACAGGTCCGAAAGATAGTGACGGTGTCGTGTTTGACCCTAGATGCAACGAGCTTTTCACAGCACGCATTAAAGTGGTCGGTCGGCCCGGTCTTAACCATTATATTTTTTTTTTCTCA
ASV482	ITS2 Extracted ITS2 sequence 56-216 (161 bp)	CAACCCTCAAGCTCTGCTTGGTGTTGGGGCCACTACGACGGTCGTAGGCCCTGAAAGTAAGTGGCGGGCTCGCTGCAACTCCGAGCGTAGTAGAATCCTATTCTCGCTATGGAGGCTTGCGGCGTCAGCTCCGGCCGTTAAAGACCCCATCTTTAACCCAA
ASV483	ITS2 Extracted ITS2 sequence 56-208 (153 bp)	CTGCCCTCAAGCCCGGCTTGTGTGTTGGGCGTGGTCCCTCCGGGGACCTGCCCGAAAGGCAGCGGCGACGTCCGTCTGGTCCTCGAGCGTATGGGGCTCTGTCACTCGCTCGGGAAGGACCTGCGGGGGTTGGTCACCACCACACGATACCAC
ASV484	ITS2 Extracted ITS2 sequence 56-251 (196 bp)	AAACCTCAACCTCCTTGGTTTCTTCTGGAGATCAAAGCAGGCTTGGACTTTGGAGGCCTTTGCTGGCACCTCTCTTTTTGAAGGCCAGCTCCTCTTAAACAAATTAGCGGGGTCCTCTTTGCTGATCCTCGACGTGTGATAAGATGTTTCCATGTCTTGGTTTCTGGCTCTGTCACCTTTGGGACCTGCTCCTAAC
ASV485	ITS2 Extracted ITS2 sequence 56-251 (196 bp)	AATTCTCAACTCTCTTATACTATTTTGTAAAGGAGAGCTTGGATTGTGGAGGCTTGCTGGCCACTTGCTTGGGGTCAGCTCCTCTGAAATGCATTAGCGGAACCATTTGCGATCTGCCACAAGTGTGATAAACTATCTACACTAGCCGGGGGATTGCTCTGTCTTGTTCAGCTACTAATTGTCTCTACTATATGAG
ASV486	ITS2 Extracted ITS2 sequence 56-208 (153 bp)	ACACCCTCAAGCTCTGCTTGGTGTTGGGCGTCTGTCCCGCCTTCGCGCGCGGACTCGCCCCAAATTCATTGGCAGCGGTCCTTGCCTCCTCTCGCGCAGCACAATTGCGTCTGCGGGGGGGTGTGGCCCGCGTCCACGAAGCAACATTACCGT
ASV487	ITS2 Extracted ITS2 sequence 55-175 (121 bp)	TAGACTCTTATACCTAGTTTTCTATGTATGAGCTTTGGACGCTGCCATTCTGTGGCTCGTCTTAAATGTCTAAGTGGAATGCGTAATAAGTTTTCGCTCCCTCCACTCTAATACTCTTTAG
ASV488	ITS2 Extracted ITS2 sequence 56-251 (196 bp)	AACTGTCAAGCTAGGATGATTTTTTTTGCTGTCCTTGCTTGGTTTGTTGGGCTTTGCCGTGTCCTTTCACTAGGAACGGGCTGGCCTTAAAAGTATTAGCCCGACTCCAAGTGGTTTATTGGTATTTCTACTCGGCGTGATAATTAGATGACCGCTGGGAAAGTGTTCCTCTTGGAACCGCCAATATTCATCTGGG
ASV489	ITS2 Extracted ITS2 sequence 56-251 (196 bp)	AATTCTCAACCTAACGGGTTCTTAACGGGACTTGCTTAGGCTTGGACTTGGAGGCTTTTGTCGGCTTGCTTTCGCATAGTCGGCTCCTCTCAAATGCATTAGCTTGGTTCTTTGCGGATCTGGCTCACGGTGTGATAATTGTCTACGCCGCGACCGGTGAAGCGTTTTAATGGACTAGCTTCTAATCGTCTTCTTG
ASV490	ITS2 Extracted ITS2 sequence 56-251 (196 bp)	CATCCTCAAACCTTCTTGGTTTCTTGACTAGGAAGGCTTTGGACTTTGGGGGCTTTTGCTGGCCTTCTCTTGTTGAAGCCCAGCTCCTCTGAAATGAATTAGTGGGGTCTGCTTTGCTGATCCTTGACGTGATAAGATGTTTCTACGTCTTGGGTTAGCACTGTTTGCTCTAGATCCTGCTTCTAACTGTCTTATG
ASV491	ITS2 Extracted ITS2 sequence 56-201 (146 bp)	TCACCCCTCAAGCTTCGGCTTGGTGTTGAGGCCTGCTGTAAAGGCACCCTCTAAAATCAGTGGCAGTGCTGTCAGGCTCTAAGCGTAGTAATTTCATCGCTATAGGGTCCTGGTGGATACTCGTCAAAACCCCCCCATTTTTTAAT
ASV492	ITS2 Extracted ITS2 sequence 56-194 (139 bp)	AACCTCACCCCACTTGGGTTTTTGCCTGAGCGGTGGTGTATTGGGTGTTGCCTTGCCAAAGGCTCGCCTTAAAAACATAAGCACCTTGGATGTAATACGTTTCATCCTTTCGGGTGGCTGATAACCCCACATATTCATG
ASV493	ITS2 Extracted ITS2 sequence 56-198 (143 bp)	AAACCATCAAGCACGGCTTGGCTTTGGACGCGGTCTGACGACCCGTCTGCAACTAGTTGGCGGTACCGTCCCGCTTCAAGCGTAGCAAGTTTACACCCTCGCTTAGGAGCTCTGGCGGCGCCTGCCAGGTGACAGCATTTAAA
ASV494	ITS2 Extracted ITS2 sequence 56-208 (153 bp)	CAAACCCTCAAGCTTCTGCTTGGTGTTGGGCCCTCGTCCCTCACAGGACGTGCCCGAAACTCGTAGGCGGTGGCGCCCAGCTCCTCAGCGTAGTTATACATTCCGCTCTGGATAGTTGGGAACCTCCCGCCTAATAAAAACACTTTTTCTATG
ASV495	ITS2 Extracted ITS2 sequence 56-251 (196 bp)	CAAACCCTCTATCCAACTTTTGTTGAATAGGATGACTGAGAGTCTCTCGATCTTTCGATCTCGAACCTCTTGAAATGTACAAAGGCCTGATCTTGTTTGAATGCCTGAACTTTTTTTTAATATAAAGAGAAGCTCTTGCGATAAACTGTGCTGGGGCCTCCCAAATAACACTCTTTTAAATTTGATCTGAAATCAG
ASV496	ITS2 Extracted ITS2 sequence 56-139 (84 bp)	GAACTATAAGCGTCATAGTTTTATGCGCCGGTGAGTCTGCTTGTGGCCTTGCTGTCCAACCATGTCCGAAAGGCATCTTGACGA
ASV497	ITS2 Extracted ITS2 sequence 56-250 (195 bp)	ACATCCTCAACCTGCTCGGTTTCATTGAAACCAAGTAGGCTTGGAATTTGGAGGTTTTCTGCTGGCCTCTTCTGAAGCCAGCTCCTCTTAAATGTATCAGTGGGATCCGCTTTGCTGCATCCTCGACGTTGATAAGATGTTTCTACGTCTTGGGTTCAAAAAAAAAAGGGGAAGGACCTGCTTCTAACCGTCCAC
ASV498	ITS2 Extracted ITS2 sequence 56-128 (73 bp)	CACCCTCTCAAGCTTCAGCTTGGTGTTGGGCTGCGCCATCGCACTGGCGGGCCTTAAAATCAGTGGCGGTGCC
ASV499	ITS2 Extracted ITS2 sequence 56-196 (141 bp)	CACCACTCAAGCCTGGCTTGGTATTGGAGGCCGCGAGCGATCGCGCCTCTCAAAGTCACCGGCTGAGCCGTCCGTCTCCAAGCGTTGTGGCAACTATCCGCGAGCGAGACCGGGCGACCCGGCCGTTAAACCCCCATCAAA
ASV500	ITS2 Extracted ITS2 sequence 56-251 (196 bp)	ATTCTTCAACCCTCCCTTTTCTTAGTGAATTGAGAGGAGTTTGGATTCTGAGTGTTGCTCCTAACCCGAGCTCATTCGTAATATATTAGCATCCATATTCGACTTCGGATTGACTTGGCGTAATAGACTATTCGCTGAGGAATCTAACTTCGGTTAGAGCCGTTTTTGAACTAGGAAGCTGCTAATCTAGCTTAGT
ASV501	ITS2 Extracted ITS2 sequence 55-249 (195 bp)	TGAATCGTAACGCACTTGGGAGTTGTTATGATTCCCAGGAGGCTGTCTTGAAGTGGGGAGTGCTTGCCTTTTCATGCCTTTCATGTTTGTCTGTCAGGTAGTTGAGCCGTTCCTTTTGGTTCTGTGCACACCCTGTTGCGGGCCCTGTCTTGCATGTTGTTGGTAGGCTTCTCTGAAATGCATTTGTGAGTGTTG
ASV502	ITS2 Extracted ITS2 sequence 56-251 (196 bp)	TCACCCCTCAAGCCCCCCGGCTTGGTGTTGGACGGCTTGGTTGACCGCAACGTCGACCCCTCCTAAAGACAGTGACGGCGCCCCGCGGCACCCCCGGTACACTGAGCTTTTCATCGAGCACGTATCGGACAAGGGTCCCCGGGACACGGTCTCTCTTTCCCACGCATCGCGGGAAATTTTTTCTGAAAGGTTGACC
ASV503	ITS2 Extracted ITS2 sequence 56-203 (148 bp)	CACCACTCAAGCCTCGCTTGGTATTGGGCAACGCGGTCCGCCGCGTGCCTCAAATCGACCGGCTGGGTCTTCTGTCCCCTAAGCGTTGTGGAAACTATTCGCTAAAGGGTGTTCGGGAGGCTACGCCGTAAAACAACCCCATTTCTAA
ASV504	ITS2 Extracted ITS2 sequence 56-251 (196 bp)	CAAACCCTCTATCCAACATTTTTGTTGAATAGGATGACTGAGAGTCTCTTGATCTATTCTGATCTCGAAGCTCTTGAAATGTACAAAGGCCTGATCTTGTTTGAATGCCTGAACTTTTTTTTAATATAAAGAGAAGCTCTTGCGGTAAACTGTGCTGGGGCCTCCCAAATAACACATCTTTAAATTTGATCTGAAA
ASV505	ITS2 Extracted ITS2 sequence 56-214 (159 bp)	CTACCCTTCAAGCTTTGCTTGGTATTGGGCATTATTATCTTTTAAGGGTAATAGGCCTTAAATATAGCCGGCGGCAAGCACTAGTCCCAAGCGTAGCAGTAAAACATTTCGCTTTAGGGAGTCTAGAGTATTGTCTACCGCATAGTATCTTTTACTATA
ASV506	ITS2 Extracted ITS2 sequence 56-208 (153 bp)	TCAACCATCAAGCTCTGCTTAGTATTGGGCGTCGTCCCCCGTGGACGTGCCTTAAACGCCTCGGCGGCGGTTTCAAACCTCAAGCGTAGTAGAATATCTTATTTAGCTTTCTAGGTTTGGGGCCGCTCTGCCTCTAGACACCAATTATCTCAA
ASV507	ITS2 Extracted ITS2 sequence 56-215 (160 bp)	TCAACCATCAAGCCTAGCTTGTCGTTGGACCCTTTGTCGTCTAGTGACAGGTCCGAAAGATAATGAACGGCGTCACGGCGACCCTACATGCAACGAGCTTATAAAATAGCACGCATATGGTGGTCGTCCGGGCCCGGTCGTCACCCTTTTATTTTCTCCA
ASV508	ITS2 Extracted ITS2 sequence 56-251 (196 bp)	TCACCCCTCAAGCCCCGTGCTTGGTGTTGGATGGCTCTGGTCGAGTAATGTCGACCCCTCCTAAAGACAATGACGGCGGCCTGTGGAACCCCCGGTACACTGAGCTTTTAACCGAGCACGTAGCGGATGAGGGTGCCCAGGACACGGTCCATCTTCCCTTTAGTGGGAAAGCTTTCAAGGTTGACCTCGGATCAGG
ASV509	ITS2 Extracted ITS2 sequence 56-213 (158 bp)	CAACCCTCAAGCCTGGCTTGGTGATGGGGCACTGCTTTCGTCCAGAAAGCAGGCCCTGAAATCTAGTGGCGAGCTCGCCAGGACCCCGAGCGTAGTAGTTATATCTCGCTCTGGAAGGCCCTGGCGGTGCCCTGCCGTTAAACCCCCAACTTCTGAAA
ASV510	ITS2 Extracted ITS2 sequence 56-251 (196 bp)	ACATCTCAAGACCCTGTCTGCTTTTGATAGGTATTGGATTTTGGGGGTTGCAGGCTGTTTCAGATTGCTTGCTCTCCTTGAATGTATTAGTGGAGAAAATCCATTGAACTCCTTTGGTGTGATAACGTCTATCAATGCCAGGAGCAATGTGTCAGTTGTCTCTGCTGTCTAACCTAGCTGTCCATAAACATGGACA
ASV511	ITS2 Extracted ITS2 sequence 56-251 (196 bp)	GCACTCTCACACCTAACCTTTGGGTTATGTCGTGGAATTGGGATGCGCCGATTTTTATTAGTCGGCACTCCTAAAATGTAGCTCTTGGCTGTTTCCTACTACAGCAGTTTGGCCTAATAGTTTTGACTTTTGTCAAATCTTTGGCTACATTTGCTTCTGGAAATCAGTCTTGATAATACAGAAAACTCATTTCAAA
ASV512	ITS2 Extracted ITS2 sequence 55-251 (197 bp)	CCACACCCTCGCTTCTCCCCTTTTTGGTGAAAAGCGGACCTGGCTGTCTCGATGCCAATCGAGTCCGCTGAAGAACAGAGGCCCGAGCGCCGCTCACCATGGGCAACAGTCTGGTAGGTGGTAGCGATACCGCATGCCGCTGTTGGCCTGAGTGCGCGCTGGAGGCCACGCAGGAAACACAAAAAAAACATTCGACC
ASV513	ITS2 Extracted ITS2 sequence 56-250 (195 bp)	AATATCTCAAAAAGCTTGTGCTTTTTTGGCATGGGATTTTTGGACATTGGGAGTTGCCGGCTGCTGATAAAGTGGTGGGCTCTTCTGAAAAGCATTAGTCGAGGAGCTTTGCACTTCTATTGGTGTGATAGACTATCTATGCCAGGAGATGCATCATGATCCTCTGCTGTCTAACTGTCTTTATCAGACAATATG
ASV514	ITS2 Extracted ITS2 sequence 56-203 (148 bp)	CAACCCTCAAGTATTACTTGGTATTGGGCTCTACTGCTTACCCAGTGGGCCTTAAAATCAGTGACGGTGTCGTTGGGGCCCTGAGCGTAGTAAATATCCTCGCTATAGGGACCTGGTAGACGCTGGTCATCAACCCCCAACTTTCTAA
ASV515	ITS2 Extracted ITS2 sequence 56-251 (196 bp)	GCACTCTCACAACTAATCTTTGTTGGTTAAGATTGTGGAATTGGGATGCGCCAATTGTGATTGATTGGCCCTCCTAAAATGTAGCTCTTGACTGTGGACTGCTACAGTAGTTTGGCCTAATAGTTTTGGCAGTTATATGTCAAATCTTTGGCTACATTTACTTTGGTCCATGCAGTCTTGATATACAGAAAACTCT
ASV516	ITS2 Extracted ITS2 sequence 56-251 (196 bp)	ATTTCTCAACCCCTCTCGATTAGCTTCGAGGGGGAGCTTGGATAGTGGGGGTTTGCAGGAAACTTGGACTTTTAGTCTAGGATTCGAGCTCTCCTGAAATACATTGGCTTGCGGTCGACTTTCGACTTTGCGCGATAAGGCTTTCGGCGTGATAATGATCGCCGTGTGCTGAAGCGCATGACTGTGAAGTTCCGTG
ASV517	ITS2 Extracted ITS2 sequence 56-206 (151 bp)	CACCACTCAAGCCTCGCTTGGTATTGGGCGACGCGGTACGCCGCGCGCCCCAAATCGACCGGCTGGGTCGACCGTCCCCTCAGCGTTGTGGCAACTATTCGCTAAAGGGTGTCGCGGTCGGTCACGCCGTAAAACAAGACCTCATTTCTAA
ASV518	ITS2 Extracted ITS2 sequence 56-251 (196 bp)	AATTCTCAACCCCTCTCGATTTTTTTCGAGGGGGAGCTTGGATGGTGGGGGCTGCCGGAGACTAGGACCTCGTCCTTGACTCGGGCTCTCCTTAAATGCATTGGCTTGCGGTCGACTTTCGACTTTGCGCGACAAGGCTTTCGGCGTGATAATGATCGCCGTTCGCTGAAGCGCATGAATGAACGTTCCGTGCCTC
ASV519	ITS2 Extracted ITS2 sequence 56-205 (150 bp)	AAGCCTTCAAGCCTTGCTTGGTGTTGGGCGTTGTCTGCGCATGTGCGGACTCGCTTCAAATGCATTGGCAGCCAGCCATGGGGTTGTTGGAGCGCAGCACATTTTGCGTTCCCAGCCCCAGGTGCCGGCGTCCACAAAGCTTATTTCAAC
ASV520	ITS2 Extracted ITS2 sequence 56-250 (195 bp)	AATTCTCAACCATGTCTCGATAGACTTCGAGGGGTGGCTTGGAGTTGGGGGTTGCCGGCGTCGGAGCGTTGTCGGCTCTCCTGAAATGCATTAGCGATGGGGACAGCAAAGTCTCTCGGACATGCCTGGTCTTTTCGATGTGATAATGATCATCGTGGGGGCTGGGGTTTGCGGGGAAGAGGGATGGTCTGATCG
ASV521	ITS2 Extracted ITS2 sequence 56-250 (195 bp)	ACTACCCTCAACTAAATTTTCATTGGGACTCCAATGGGAAAGCAGTTGGAGTTGGCCGTCCGGTGGCCTTTAGGTTGCCGGTCAGCTGAAATACAATCACGCTTTGTGGGCTCCTTTCCAACTGGAAAGACGAGTTCCGATTTGGTAGGTGACCTTTGCCGGTTGCATGCCTTCGTTGCTCGTTATGCCTTTCAT
ASV522	ITS2 Extracted ITS2 sequence 56-251 (196 bp)	ACACCTCACTACTATAACTTTTGTTGTAATAGTGGACTTGGAATGCGCTGGTGTCAATCAGCCCTTCTAAAATGGAGTTCTTGCACTGTTGATTTGTTTTAACAGCATGTTGGCCTAATAAGTTTCGGCAGTAATGTTGAAATCCTGGCTTTTTTTGCTTAGAATCTGACAGTCTTGATATACAGAATTTTTGAGG
ASV523	ITS2 Extracted ITS2 sequence 56-251 (196 bp)	AATTCTCAACTCTCTTATACTGTTTTGTGAAGGAGAGCTTGGATTGTGGAGGTTTGCTGGCCACTTACTTGAGGTCAGCTCCTCTGAAATGCATTAGCGGAACCGTTTGCGATCTGCCACAAGTGTGATAAACTATCTACACTAGCCGGGGGATTGCTCTGTGTTGTTCAGCTACTAATTGTCTCTATTTTGAGAC
ASV524	ITS2 Extracted ITS2 sequence 56-251 (196 bp)	ATTCCTCAAACCTTCTTGGTTTCTTGATCAAGAAGGCTTTGGACTTTGGAGGTCTTTGCCGGCTTTGCGAAAAGTCGGCTCCTCTTAAATGCATTAGTGGGGTCCCCTTTGCCGATCTCTAGGCGTTGATAATACGTTTCTACGTCTTGGGATTTGCTCTGTTCCTTGGGAATCCACTTCTAACCGTCTCACCGTC
ASV525	ITS2 Extracted ITS2 sequence 56-250 (195 bp)	CTACTCTCGGTTCCGATATCTTTCGGGGTATCGGGACCGGAATTTGGGAGCTTGCGGGCGTCCTTGTTTGAGGGGACGTCGGCTCTCCTCAAATGCATTAGCGGAGAGGAGCGTGACCGAAGCCGAGCGATCGGAGCGTGACCTTTTTTTTCCCTCGGCGTCGTAAGGATCGTTGTGGGTTTCGGGGAGCGTCAG
ASV526	ITS2 Extracted ITS2 sequence 56-207 (152 bp)	ACACCCTCAAGCTCTGCTTGGTGTTGGGCGTCTGTCCCGCCTCTGCGCGTGGACTCGCCCCAAATTCATTGGCAGCGGTCTTGCCTCCTCTCGCGCAGCACAATTGCGTTTCTTGAGGTGGGTGGCCCGCGTCCACGAAGCAACATAACCGT
ASV527	ITS2 Extracted ITS2 sequence 56-250 (195 bp)	AATTCTCAACTCCCTTATGCTGTTTGGTATAGGAGGAGCTTGGATTGTGGAGGCTTGCTGGCCACTTGTCTGAGGTCAGCTCCTCTGAAATGCATTAGCGGAACCGTTTGCGATCTGCCACAAGTGTGGTAATTTATCTGCACTGGCAAGGGGGATTGCTCTCTGTGATGTTCAGCTTCTAACTGTCTCTTGATG
ASV528	ITS2 Extracted ITS2 sequence 55-159 (105 bp)	TCTAATTCAGCACTAGCTGGCTTTGGACGTGCCTACGGGCTGTCTGCAATGAAGTGACCGCGGTCATGGCTGACAGGAGTCGCCACGCGGCAAAAATCTTATGAC
ASV529	ITS2 Extracted ITS2 sequence 56-172 (117 bp)	CACTATTCTTCGGAGTATTGACAGTGGCTTACGCCTTGTCTAAAACCCTTGGTGGTAACTATCAATCACGCATAGTAATCTCTGCGAAGGTGGATAGGTAAACACTGAAAACTTCTT
ASV531	ITS2 Extracted ITS2 sequence 56-173 (118 bp)	AATTCTCAAGTCATTGGCTTGGAATTGGGGGTTGCTGGTCTATATAGTCAGCTCTCCTGAAATACATACATTTGTGGCCTTTTCGATGTGATAATGAACATCGTAGGGCACTTAGTGA
ASV532	ITS2 Extracted ITS2 sequence 56-208 (153 bp)	GTACCCTCAAGCTCTGCTTGGTGTTGGGTGTTTGTTCCGCCGCGCGCGCGAACTCGCCTCAAATGTATTGGCAGCCGGCAATCTGGTGTTGGAGCGCAGCACAATTTGCGCTCTTCGCTGTATTGCGGCGTCCACAAAGCCCATATTTTTTAC
ASV533	ITS2 Extracted ITS2 sequence 56-251 (196 bp)	AATTCTCAACCTTCCAACTTTTATTAGCTTGGTTAGGCTTGGATGTGGGGGTTGCGGGCTTCATCACTGAGGTCGGCTCTCCTTAAATGCATTAGTGGAACTTTTGTGGACCATCTATTGGTGTGATAATTATCTACGCCGTGGGTGTGAAGCAGCTTTATGAAGTTCTGCTTCTAACCGTCCATTGACTTGGACA
ASV534	ITS2 Extracted ITS2 sequence 56-207 (152 bp)	ACACCCTCAAGCTCTGCTTGGTGTTGGGCGTCTGTCCCGCTTTACGCGTGGACTCGCCCCAAAGTCATTGGCAGCGGTCGTGCCAGCTTCTCGCGCAGCACATTTGCGTTTCTTGAAGCTTGGTGGATCAGCATCCAGTAAGTTCTTCTATG
ASV535	ITS2 Extracted ITS2 sequence 54-251 (198 bp)	CAAAACAACCTTCGGTCGGTCTTTCAAGATCTCGATCGGTCATGGGCTCGGAGTAAGGGGATCAATCCCACCCTCCGGCTTTAAAATTGCTACGCGACCGCAAGCTATTCCCGGCTAGGTTAACGGATTGGTATTTACATGTCTTCCGCTGCCTTTCGGATACCGCTTCCGCGGCGTTAAACGTCATGTTGCCCGTCA
ASV536	ITS2 Extracted ITS2 sequence 56-209 (154 bp)	TCACTAATCAAGCCCGGCTTGCTGTTGGACCTCTTGTCGTTAAAAGACAGGCCCTAAAGATAATGACGGTGTCAGTTGGACCCTAGATGCAACGAGCTTTAACCAGCACGCGTCGTAGTGGCCTTTTGACCCGGTCTTTTTAACCAATTTCTAA
ASV537	ITS2 Extracted ITS2 sequence 56-251 (196 bp)	TAATCTCACTCCGACAACTTTATTGTTGTCTGGAGGTGGACTTGGACCTTGCTGTGTCACAACGGCTGGTCTGAAATGTATGAGTGCACCCCGCTGTAGCAGCGTCTTCAGTGTGATAAGTATCTTCACTGATTCAAGTTCCCTCGGGACACGCTCGTCTGGTGGGCTCTGGGCTTCTAACCGTCCGCATGGACAA
ASV538	ITS2 Extracted ITS2 sequence 56-207 (152 bp)	ACACCCTCAAGCTCTGCTTGGTGTTGGGCGTCTGTCCCGCCTCTGCGCGCGGACTCGCCCCAAATTCATTGGCAGCGGTCCTTGCCTCCTCTCGCGCAGCACATTGCGCTTCTCGAGGTGCGCGGCCCGCGTCCACGAAGCAACATTACCGT
ASV539	ITS2 Extracted ITS2 sequence 56-218 (163 bp)	AACTATCAAAACACTTTTTGTTGAAATGTTTTGGACTTTGGGAGTACTGTGCTGGTCTCTTTTGTTTTGGAGCCAGCTCTCCTCAAAAGCATTAACTTTGGAGAACCATCAGTGTGATATATCATTTTGTTTATACGCTGGCTTTCTCCTTTTAAAAATGCCC
ASV540	ITS2 Extracted ITS2 sequence 56-205 (150 bp)	CGACCCTCAAGCATTGCTTGGTGTTGGGCAAGGTCCTTTGGGGGACCTGCCCGTAACTCGTAGGTGGCAGCCGGTGGTGCCTCCAGCGTAGCAGGCTAACGCACTCGCTGGGGGTAGCCCGCGAGGCCCGCCCAAACTTTTTACCCAAAG
ASV541	ITS2 Extracted ITS2 sequence 56-216 (161 bp)	CAATGTTCAAGCTTTGCTTGCTGTTGGGCGTCTGTCCCCGCCATTTCGCGTGGGGACTCGCCTTGAATCTATCAGCGTCCGTATGGTTAGGCTAAGAGCGCAGCAGATTACAGCGCCTCGAAGCCTAGCGTAACGCCTGCTGTAAAATTACATTTAAACTT
ASV542	ITS2 Extracted ITS2 sequence 56-251 (196 bp)	AAACTACCCAACACTTTGCTGTTTTATAAACAGCAATGTGCTGGTTTTATGGTGTGTTTGTTTATGTAAATAAACAATCCACTAAAAAATTCTGGATGCTTGGATCAGTCTTTGATGATATGAGTCTATACACTGCAACAGATAATGAATCAGTATATGGGAGCATGACATGAAAGCTCGTTTGAGTATCTTCAAA
ASV543	ITS2 Extracted ITS2 sequence 56-214 (159 bp)	CACCACTCAAGCTCTGCTTGGTATTGGGCCCTCGTCCGCCTCCGGGGGGACGTGCCCGAAAATCAGTGGCGTCGCCGCCTGACTTCAAGCGCAGTAATTTTCTTCTCGCTTTGGAAGGAAGGGTCGGCCGACCGCCAGACAAACCCATTATTTTTCTAT
ASV544	ITS2 Extracted ITS2 sequence 56-216 (161 bp)	AACCTTCAACCCCCGGGTTTTGTTCCCGGTGGGCTTGGACTTGGGCGCTGCCGATCGCCGGCTCGCCTCAAATGTGTTAGTGGACTAGGTCCTGCTGCCTGACGTGATAAGTTTCGTCTCGCCGGCTGCCGACGCCCGCTCATAACCCCCCATATTTTGTG
ASV545	ITS2 Extracted ITS2 sequence 56-199 (144 bp)	CAAACCTCAAGCTCAGCTTGGTCTTGGGCGAGGTCGGCTTCCGACCCGTCTCCAACTCAACGGCGATCACGTCCGGTCTCGAGCGTAGCAGAAACACTCGCTCAGTGGTCCCGGCGGCGGTCCGCCACAAAGACTCTTTCTGAA
ASV546	ITS2 Extracted ITS2 sequence 56-250 (195 bp)	AATCTCCCACCCCAAGCGGTTTTTACATGAAACGGCTTGGCGGATGGGGTCTGGATGGGTGCCTCTGCCTGCGCTACCTAGCACAGGCTCGCCCGAAATGCATGAGCGCCTTGAGACACTTTGCATCCGCCTCTCTGTTTGGGAGGAGGCGGCCAAGCAGTGTTTTTCTCCTGGCATGGCATGATACGTCATTTG
ASV547	ITS2 Extracted ITS2 sequence 56-216 (161 bp)	TCCTCCCTCAAACCCCAGGTTTGGTGTTGGACCTGAGTTGTGTGAACAACTGGTCTCAAAGACAATGACGGCGTCCGTGGGACCCTCGGTGCAACGAGCTTTTAGGAGCACGCATCGAGTTGCAAGGACCTTCCGGGCCGGTCTCCTTTACTATTTTACAA
ASV548	ITS2 Extracted ITS2 sequence 56-216 (161 bp)	CACCACTCAAGCCTGGCTTGGTATTGGGCGTCCGCGGCGGCCTGCACTGGCGGCCGCGCGCCCTAATGTCTTCGGCTGAGCCGTCCGTCTCTAAGCGTTGTGGTCATTCAGTTCGCTTGCGAGGCCGGGCCGGCTTGTCGCCGTTAAACCCCCCATCTCAA
ASV549	ITS2 Extracted ITS2 sequence 56-216 (161 bp)	CTACCATTCAAGCTTGCTTGGTTTTGGGTATTGTAGCACTCTCAACTTAGGGTTTTACATATCTTAAATGTAGACGGCAGCAAGTATAAGTTCTGAGCGTAGCAGTAATAACATTTCGCTTTTAGAAACTTATATTTGTTAACCGGAAAAGTATATTTACA
ASV550	ITS2 Extracted ITS2 sequence 56-195 (140 bp)	CACCACTCAAGCCTGGCTTGGTATTGGGCGTCGGGGTCTCCCCGCGCCTCTATGTGACCGGCTGGACGATTGGAATCCTCAGCGTTGTGTATCAATTCGCTCAGGGGACCGTCGGCCGCGCCGTTAAACCCTCTATTCAA
ASV551	ITS2 Extracted ITS2 sequence 56-205 (150 bp)	CACCACTCAAGCCTGGCTTGGTCTTGGGCCGCCGCGGGGCTTCCCGCGCGCCCTCATGTCGTTCGGCTGGACCGCCCGTCTCGAAGCGTTGTGGCAACCATTTCCGCTTGCGAGACCGGGGGGGCCCCGGCCGTTAAACCTCCCACGAAA
ASV552	ITS2 Extracted ITS2 sequence 55-250 (196 bp)	TGAATCGTAACGCACTTGGGAGTTGTTATGATTCCCAGGAGGCTGTCTTGAAGTGGGGAGTGCTTGCCTTTTCATGCCTTTCATGTTTGTCTGTCAGGTAGTTGAGCCGTTCCTTTTGGTTCTGTGCACGCCCTGTTGCGGGCCCTGTCTTGCATGTTGTTGGTAGGCTTCTCTGAAATGCATTTGTGAGTGTTGC
ASV553	ITS2 Extracted ITS2 sequence 56-251 (196 bp)	AACACCTCAACCTCCTCTTGATTTTTCAAAAGGAGGGTGGACTTGAGCTATCCCAACAACCTTTACCGGTAGGCGGGTGGCTTGAAATGCAGGTGCAGCTGGACTTTTATCTGAGCTAAAAGCATATCTATTTAGTCCTCGTCAAACAGGATTATTACTATTGCTGCAGCTAACATAAAGGATAATTGTCCTCATT
ASV554	ITS2 Extracted ITS2 sequence 56-207 (152 bp)	CACCACTCAAGCCTCGCTTGGTATTGGGCGACGCGGCTAGCCGCGCGCCTCAAATCTCCCGGCTGGGTCCGAACCGTCCCTCAGCGTTGTGGAAACCATTCGCTACAGGTGCGCGCTTCGGTCACGCCGTTAAACAAGCCCAATTCATTAAA
ASV555	ITS2 Extracted ITS2 sequence 56-251 (196 bp)	AATTATCAACCTTCTTGCTTTGCTTGCGAAGCATCTAGGCTTGGACGTGGGGGTTTTGCTGGCTTCCTTCAGTGGATGGTCTGCTCCCCTTAAATGCATTAGCGGGATCTCTTGTGGACCGTCACTTGGTGTGATAATTATCTATACCATTTGGCTTTGAAGCAAACTTTATGAGGACCTGCTTATAACCGTCTCT
ASV556	ITS2 Extracted ITS2 sequence 56-251 (196 bp)	ACTCTTCAACCCACTGGTTTCTTGTAGACTAGCTGGTGTTTGGATTTTGAACGTTGCTGGTCTTCGGACGTAGCTCGTTCGTAATACATTAGCATCTCTAATTCGAATTCGGATTGACTCAGTGTAATAGACTATTCGCTGAGGACACTTTTATTAGTGGCCGAACAAGATAATTGTAGAAGCTTCAAACCTCTAT
ASV557	ITS2 Extracted ITS2 sequence 56-191 (136 bp)	TGACCAATCACGCAAGTGGTATTGGGGCTTGCCGTCGGCATCCCTTAAAATCAGTGGCAGTGCTATAGGCTCTCAGCGCAGTAATTATTTCGCTCTCGAGTCCTAGACCCACCCGCCAAAACCCCAACTTTCTTAA
ASV558	ITS2 Extracted ITS2 sequence 56-248 (193 bp)	ACATCCTTCAACCTTTCTTGGTTTCTTGACCGGGGAAGGCTTGGACTTTGGGGGTTTTCATTGCTGGCCTCCCTTGAAGCCAGCTCCTCCTAAATGGATTAGTGGGGTCTGCTTTGCCGATCCTTGACGTGATAAGATGTTTCTACGTCTTGGGTCTCGCACTGTCGCTTCAGACCCCGCTTCAAACAGTCTT
ASV559	ITS2 Extracted ITS2 sequence 56-192 (137 bp)	TAACCATCAAGCCTAGCTTGGTATTGGAGCCCGCGTCTGCGGCTCCCAAAAACAGTGGCAGTCTTTACAGACCCTAAGTGTAGTAACATATCTCGCTTTTGGACTCTGTAGCGGTTCGCCAGAATCTAAACTTTTCA
ASV560	ITS2 Extracted ITS2 sequence 56-218 (163 bp)	AACTATCAAAACACTTTTTGTTGAAGTGTTTTGGACTTTGGGAGTACTGTGCTGGTCTCTTTTGTTTTGGAGCCAGCTCTCCTCAAAAGCATTAACTTTGGAGAACCATCAGTGTGATATATCATTTTGTTTATACGCTGGCTTTCTCCTTTTAAAAATGCCC
ASV561	ITS2 Extracted ITS2 sequence 56-207 (152 bp)	GTACCTTCAAGCTCTGCTTGGTGTTGGGTGTTTGTCTCGCCTCGCGCGTAGACTCGCCTTAAAACAATTGGCAGCCGGCGTATTGATTTCGGAGCGCAGTACATCTCGCGCTTTGCACTCATAACGACGACGTCCAAAAGTACTTTTTACAC
ASV562	ITS2 Extracted ITS2 sequence 56-250 (195 bp)	AATTCTCAAAACCCTTTCTTTTTGGTTGTTGTTGACCGTGGAAAGGATTTTGGACTTGGAGGCCTTTTGCTGGTTTCACCTTTGAAGCGAGCTCCTCCCAAATGAATTAGTGGGGTCTGCTCTGTCGGTCCTTGGCGTGATAAGTTGTTTCTACGTCTCGGATTTTGGCACTGTACACCTGCTTCTAACCGTCTC
ASV563	ITS2 Extracted ITS2 sequence 56-251 (196 bp)	ATTCCTCAACCTTCTGCTATTTCTTGATAGCAGAAGGCTTGGACTTTGGAGGTTCTTGCTGGCCTCTCCTTCTAGAAGCCAGCTCCTCTTAAATGGATTAGCAGGGTCTGCCTTTAGTCGATCCTCGACGTGATAAACCATTTCTACGTCTTGGACTTGGCTCTTTTGAGACCTGCTTCTAATCGTCCGAGTCGCC
ASV564	ITS2 Extracted ITS2 sequence 56-223 (168 bp)	CAACTTCAACTTTATTGTTGGTATTGGAATTTCTAATTCTCTTGGGAATCAGTTTTCTGAAATTTAATGGTGAATCTTGTTCAAGACCAAATAAAACGTATTAGGTTTTTTCCAACTCGTTTTCCAAGGTTTTTTACTAACCGGTTCTCCTTAATAAAACCCCAATTT
ASV565	ITS2 Extracted ITS2 sequence 56-251 (196 bp)	CCTTCTCAAACCCTCGGGTTTGGTAGTGAGTGGTACTCTTTCTGGGTTAACTTGAAAATGCTGGCCATCTGGCTGTTGCTGACTGAGGTTTTAGTCCAGTCCGCTGATACTCTGCGTATTAGGTTTTACCAACTCGTAGTGGCGTTAGTAGGCGTTTTAAAGGCTTTTACTGAAAGTACAGACAGTCTGGCAAACA
ASV566	ITS2 Extracted ITS2 sequence 56-143 (88 bp)	GAACTATAACGCACTTGGGGATTGTGCCCAGGAGTGGGGAATGCTTGCCTTTTGTGCTGTCTGTCAGGTAGTAAAGGCATCTTGACGA
ASV567	ITS2 Extracted ITS2 sequence 56-250 (195 bp)	ATTACCCTCAATCACCTTCCATTGGATTTCCAGTGAGAAGGCAATTGGAACTGGCCGTCCGGTTTGCCCTCTGGTTGCCGGTCAGCTGAAATATAATCACGCTTTGAGGGCTCTTTCCTACATGGGAAAGGCGAGTTCCGATTTGGTAGGTGACCTTTGCCGGTTGCATGCCCTTCGTTGCTCGCTGTGCCTTTC
ASV568	ITS2 Extracted ITS2 sequence 56-251 (196 bp)	AAGTATCTCAAAAGTACTGTTGCACTATGCTCCAAGAACTTTTGGACGTTGGGAGTTGCTGGCCACTTATAAAGTAAGTGGTGGGCTCTTCTGAAAAGCATTAGTTGAGGAGGTTTTGCACTCTATTGGTATGATAGACTATCTATGCCAGGAGAAGCATTATGAAGCCCTCTGCCATCTAATGGTCCTTAATGGA
ASV569	ITS2 Extracted ITS2 sequence 56-199 (144 bp)	CACCACTCAAGCCTGGCTTGGTATTGGGCGCCGCGGTCAATCCGCGCGCCTCAAAGTCTCCGGCTGAGCTGTCCGTCTCTAAGCGTTGTGATTTCATTAATCGCTTCGGAGTGCGGGCGGCCGCGGCCGTTAAATCTTTCACAA
ASV570	ITS2 Extracted ITS2 sequence 56-208 (153 bp)	AACCCTTCAAGCATCGCTTGGTGTTGGGCGCCTGTCCCGCCTCCGCGCGCGGACTCGCCTTGAAAGCATTGGCAGCCTGTGTATTGGCTTCGAGCGCAGCAGATTCGCGCCTCGTCCCCTCTCCGCACAGGCGTCCATTAAGCCACCCCCATA
ASV571	ITS2 Extracted ITS2 sequence 56-251 (196 bp)	AAATCTCAAATCCTAGCTTTGCTTTGTCGGAGCTCGGTTTTGGACTTTGGGAGTCTGCGGGCGGCCCTTTGCTTGGGACGTCGGCTCTCCTCAAATGCATTAGCGGTGGGCGCGAGCCTTTGCACGGCACGGCCTGTTTGACGTCGTAGTGATCGTCGCGGGCTGGAAGTGCTTGGATTGACATGTCTCATGCTTC
ASV572	ITS2 Extracted ITS2 sequence 56-212 (157 bp)	TCACAATATCAAGCTTGGCTTGTTGTTGGGCCCTTTTGTCACCTGGTGACAGGTCCAAAAGACAATAACCGGTGTCATACAGACTCTATATGCAACGAGCTTATAACAGCACGCATCTGGTGGTCGTGTGGCCCGGTTTTCACTTTAAATTTCTCAA
ASV573	ITS2 Extracted ITS2 sequence 56-138 (83 bp)	AAACCCTCAAGCTATGCTTGGTGTTGGGCGTCTGTCCTGCCACTGGCGCGGACTCGCCTTGAAAATATTGGCGGTTGGTGCAC
ASV574	ITS2 Extracted ITS2 sequence 56-251 (196 bp)	AACACCTCAACCTCCTCTTGTTTTTTCAAAAGGAGGGTGGACTTGAGCTATCCCAACAACCTTCACCGGTAGGCGGGCGGCTTGAAATGCAGGTGCAGCTGGACTTTTATCTGAGCTAAAAGCATATCTATTTAGTCCTCGTCAAACAGGATTATTACTATTGCTGCAGCTAACATAAAGGATAATTGTCCTCATT
ASV575	ITS2 Extracted ITS2 sequence 56-251 (196 bp)	GATATCTCAAAAAACTTGTGCTTTTTTGGCACAAGACTTTTGGACATTGGGAGTTGCCGGCTGCTGATATACAGTGGTGGGCTCTTCTGAAAAGCATTAGTCGAGGAGCTTTGCACTCTATTGGTGTGATAGACTATCTATGCCAGGAGATGCTCCATGATCCTCTGCTATCTAACTGTCTTTATGAGACAAATAT
ASV576	ITS2 Extracted ITS2 sequence 56-209 (154 bp)	ACACCCTCAAGCTCTGCTTGGTGTTGGGCGTCTGCCCCGCCTTCGCGCGCGGGCTCGCCTCAAAGTCATTGGCAGCGGTCTCGCCGGCTTCTCGCGCAGCACATTTGCGCTTCTCGGAGCCCCGGCGGATCGGCGTCCAGCAAGCACTTCTACG
ASV577	ITS2 Extracted ITS2 sequence 55-251 (197 bp)	AAAAATCTCATCGCTACTCGCTGGCTTTTAGCGCCGCGAGGGGCGATGGTTCTGGATTTTTGCCGTTGGCAATTGTCTGAAATTGATTGTATGTGCACCAATCGATGCGTCATTTGGTTGTCCAAGTGCAACAGGTGGTTTTCTCCATTTTCGCTTTGGCAGCTGCTCGACAGTCGTGATGCGCTTACTCTAAAGTC
ASV578	ITS2 Extracted ITS2 sequence 56-251 (196 bp)	ATTCCTCAACCTTCTGCTATTTCTTGATAGCAGAAGGCTTGGACTTTGGAGGTTCTTGCTGGCCTCTCCTTCTAGAAGCCAGCTCCTCTTAAATGGATTAGCAGGGTCTGCCTTTAGTCGATCCTCGACGTGATAAACCATTTCTACGTCTTGGACTTGGCTCTTCTGAGGCCTGCTTCTAATCGTCCGAGTCGCC
ASV579	ITS2 Extracted ITS2 sequence 56-131 (76 bp)	CACCACTCAAGCACTGCTTGGTATTGGGCACCCGTCCGCCGAAAGGCGGGCGTGCCTCGAAGACCTCGGCGGGGCC
ASV580	ITS2 Extracted ITS2 sequence 56-251 (196 bp)	CAAACCCTCTATCCAACTTTTGTTGAATAGGATGACTGAGAGTCTCTTGATCTTTCGGTCTCGAACCTCTTGAAATGTACAAAGGCCTGATCTTGTTTGAATGCCTGAACTTTTTTTTAATATAAAGAGAAGCTCTTGCGATAAACTGTGCTGGGGCCTCCCAAATAACACTCTTTTAAATTTGATCTGAAATCAG
ASV581	ITS2 Extracted ITS2 sequence 56-204 (149 bp)	TCAACCATCAAGCCCAGCTTGGTATTGGGTTTCGCCCTTAACCGGGCGGTCCCTAAATGTCTAGGCGACGGCATCAAACCTCAAGCGTAGTACAATCATCAGCTTTTTAGGTTTTGGTGCTGTCACGCCCATAGTACACAACACCTCAA
ASV582	ITS2 Extracted ITS2 sequence 56-202 (147 bp)	CACCAATCAAGCCTCGCTTGGTGTTGGGCGATGCGCACGTCGCACGCCTCAAATGCCCCGGCCGAGCAGTCTCTCACCCGGCGTCGTGGAAACATACCGCTACGGAGACGAGACCTGCCCGTGCCGCAGAATAACCTATTTTCTAAA
ASV583	ITS2 Extracted ITS2 sequence 56-202 (147 bp)	CACCAGTCAAGCCTCGCTTGGTGTTGGGCGCCGCGGTCCGCCGCGCGCCCCAATGTCTCCGGCTGAGCCGTCCGTCTCGAAGCGTTGTGGCAACTCATGATCCGCTTCCGGGACCGGGCGACGCCACGCCGTCAAAACCTCTCACCA
ASV584	ITS2 Extracted ITS2 sequence 56-251 (196 bp)	TCCTTATAATCAAACTTTTATATATCTATATAAAGATGTTTGGATGTTAAATTGAGAAGAGTAGTATTGTTATAATACTACTTTCTTAAAAACTAGAAATACTTTATTTTGGTTTTATTCCCAACTCATTTTATATTTAATAACACAAATGAAGTGAGAATTTAATACAGAAATAATAAAAATATTGGATGACCTC
ASV585	ITS2 Extracted ITS2 sequence 56-251 (196 bp)	AAGTTCTCAACCGTGCACCAGATTGTGCGGCTTGGAAGTTGGGGGTTTGCTTTTGCAGGTTTCCTATGATTGTGAAGTCTGCTCCCCTGAAATGAATTTAGTGGTAGGGCTTACAACACTAGGTGTGATAAAACTATCTATGCCTTCTAGTATGCTGCATCACTTCTAAAGAGAAACCTTTTTGATGAATTTGACC
ASV586	ITS2 Extracted ITS2 sequence 56-87 (32 bp)	GAACTATCCATGTCCGAAAGGCATCTTGACGA
ASV587	ITS2 Extracted ITS2 sequence 56-251 (196 bp)	GCACTCTCACACCTAACCTTTGGGTTATGATGTGGAATTGGGATGCGCCGATTTTCATTAGTCGGCACTCCTAAAATGTAGCTCTTGGCTGTTTCCTACTACAGCAGTTTGGCCTAATAGTTTTGACTTTTGTCAAATCTTTGGCTACATTTGCTTCTGGAAATCAGTCTTGATAATACAGAAAACTCATTTCAAA
ASV588	ITS2 Extracted ITS2 sequence 56-251 (196 bp)	ATTCTCCCATCCCAAGCGGTTTTTATCAAAGAATTTCTAGGCGAAGGGGTTGAGATGGGCGTTGTTATAACTGCTTTTCTTCTCTAGAAAAGCTCGCCCGAAAAACAGCTAACGCCTCTGGGCCACTTTGCATCCGCTTCTCTGAGGGGAGAGGCGGCCAAGCGCGCTCTGATCATCAGGCATAGCATGATACGTC
ASV589	ITS2 Extracted ITS2 sequence 56-251 (196 bp)	CATTCTCAACGACCGGCGTATGTCGGAAGCCGGGGTTCTTCGGATCTCCGTCTCGGGCGTAGGCCGGTCAGGTTGTTGGGTCGTTCCTTCTCTCGCCTTTTCGGGCAGAGGGAGATCACCTCAAAGTGATTATTTGCGTTGCTCTAGCCTCGTCGGCCAGAAGTATAAAACCAAGTGCAACAGATGTTTATTCATT
ASV590	ITS2 Extracted ITS2 sequence 56-229 (174 bp)	TCACCCCTCAAGCCCCGTGCTTGGTGTTGGACGGCTTGGTCGCGCCCGCGACCCCTCCTAAAGACAACGACGGCGGCCTGTGGTTCCCCCGGTACATTGAGTGTATTCGCACACGTATCGGACAAGGGCGCCCAGGTCCCGGTCCTCTCCCCCTCGCGGGGACATTTTTATCTA
ASV591	ITS2 Extracted ITS2 sequence 56-251 (196 bp)	ACTTCTCACAAAACCTTCTGGTTTCTGTTGATGTTGGGAGTTGCGTTTCCTTGTGAGACGCTCTCCTCAAATGCATTGGTGCGGCCTGCCGCCCGGTTACACAACGTTCTAGGTTCGTCCAACTCGTTGCTAAATCGGTGCACCATTTGGTGCTGCACCTAAAGCCCGCCTTGTGCCTTGTGCTCTTGGCTTATCT
ASV592	ITS2 Extracted ITS2 sequence 56-251 (196 bp)	AATCTCAATCTAATATGTTTTCTGAACATGTTAGACTTGGACTTGGGCGTCTGCCAGTGATGGCTCGCCTCAAATGACTTAGTGGAACATCCCACATCAGTGTTAGACGTAATAAGTTTCGTCTCTCCTTGTGGTGATGACTGCTCAGAACCTGCCATCGCGCACTTTTGACTTTGACCTGAAATCAGGTAGGGCT
ASV593	ITS2 Extracted ITS2 sequence 56-197 (142 bp)	ACACCCATCAAGCCTGGCTTGGTATTGGGCGTCGGGACTTTCTCCCGCGTCCCGATTTCGCCGGCTGGACGACCCGGATCTCAAGCGTTGTGATGAATCTCGCTAGAGGAACGGGCGGCTACGCCGTTAATCTTTCAATCGA
ASV594	ITS2 Extracted ITS2 sequence 56-217 (162 bp)	AATCCAATCAAGCCTGGCTTGGTATTGGGCGTCAGGGGTTCCCCGCGCCTCAATTTCACCGGCTGGCCGTCGCCCGTCTTAGCGTTGTGACACATCTCTCGCTACCGATGAGACCGGACCACGCCGTTAAAACTCCATGAATTTCAATCGAAATTTGATTAA
ASV595	ITS2 Extracted ITS2 sequence 56-140 (85 bp)	CACCACTCAAGCACTGCTTGGTATTGGGCATCGTCCGTCGAAAGACGGGCGTGCCTCGAAGACCTCGGCGGGGCCTAACCGGCTT
ASV596	ITS2 Extracted ITS2 sequence 56-221 (166 bp)	CTGCCCTCAAGCCCGGCTTGTGTGTTGGGCCCCGTCCCCCCCGCCGGGGGGACGGGCCCGAAAGGCAGCGGCGGCACCGCGTCCGGTCCTCGAGCGTATGGGGCTTCGTCACCCGCTCTAGTAGGCCCGGCCGGCGCCAGCCGACCCCCAACCTTTAATTATCTCA
ASV597	ITS2 Extracted ITS2 sequence 56-251 (196 bp)	ATTCTATCCACTCTTAGTTAAAAGGGTTGGGACTTGGGAGATTTACTTGCAGAGTTGAATATCTGCTCTCCTTGAATGTATTAGCAGGGATTTTATTAGTCCTTGGATTGATTGTGATAATTAAAACATCTCTTCAAATTCTTGGGTCTAAGTTGTTCATCTGCTTCAAACAGTCTTTACTTATTAGTAGACAAAG
ASV598	ITS2 Extracted ITS2 sequence 55-251 (197 bp)	AAAAGAATCTTTAACCAATTTTTTGGTCAAAGGAAATGAGTTCTCCGCGTTTATAGCGGTAGCTTGAAATAAATGGTCAAGTCTCATTTTAGTCGAGACGCGTAATAATATTATTTCGCGAAATCTTCATTATGTGACTATCAAGTTTTGATGCATACAAATTTGGTTTGTTTGCGATCAATACAAATATTTTTGAA
ASV599	ITS2 Extracted ITS2 sequence 56-228 (173 bp)	CACCAATCAAGCACCGCTTGGTATTGGGGATGGTCCCGGCCCTCTCGAGGCGCCGGGGCCTCTCCCGAAATGTATCGGCGAGGACCTCCGACCCCCGACGTGTTAGGAAACTCAAGACGTCAGGAGCACCGGTGGACACTCCGCCGTCGACCTCCCCTCGGGGAACTTTCAAA
ASV600	ITS2 Extracted ITS2 sequence 56-209 (154 bp)	TCACGGTATCAAGCTTGGCTTGGTGTTGGGCCCTTTGTCGCCTGGTGACAGGTCCGAAAGACAATGACTGGTGTAACAGACTCCATATGCAACGAGCTTATAACAGCACGCATTTGGCAGTTGTGTGACCCGGTCTTCACCCTTTCTTTCTCAA
ASV601	ITS2 Extracted ITS2 sequence 56-209 (154 bp)	GTACCTTCAAGCTTTGCTTGGTGTTGGGTGTTTGTCTCGCCTCTGCGTGTAGACTCGCCTTAAAACAATTGGCAGCCGGCGTATTGATTTCGGAGCGCAGTACATCTCGCGCTTTGCACTCATAACGACGACGTCCAAAAGTACATTTTTACAC
ASV602	ITS2 Extracted ITS2 sequence 56-211 (156 bp)	TCACCATATCAAGCTTGGCTTGTTGTTGGGCCCTTTGTCACCTGGTGACAGGTCCAAAAGACAATAACCGGTGTCATACAGACTCTATATGCAACGAGCTTATAACAGCACGCATCTGGTGGTCGTGTGGCCCGGTTTTTTAAATATATTTCTCAA
ASV603	ITS2 Extracted ITS2 sequence 56-251 (196 bp)	ATTCTCCCATCCCAAGCGGTTTTTATCAAAGAATTGCTAGGCGAAGGGGTTGAGATGGGCGTTATTATAACTGCTTTTCTTCTCTAGAAAAGCTCGCCCGAAAAACAGCTAACGCCTCTGGGCCACTTTGCATCCGCTTCTCTGAGGGGAGAAGCGGCCAAGCGCGCTCTGATCATCAGGCATAGCATGATACGTC
ASV604	ITS2 Extracted ITS2 sequence 56-203 (148 bp)	CACCACTCAAGCCTCGCTTGGTATTGGGCAACGCGGTCCGCCGCGTGCCTCAAATCGACCGGCTGGGTCTTCTGTCCCCTAAGCGTTGTGGAAACTATTCGCTAAAGGGTGTTCGGGAGGCTACGCCGTAAAACAACCCCATTTCTAA
ASV605	ITS2 Extracted ITS2 sequence 56-251 (196 bp)	GAACTATAACGCACTTGGGGATTGTGCCCAGGAGGCTGTCTTGAAGTGGAGAGTGCTTGCCTTTTGTATTGTCTGTCAGGTGGTTGGCCATTCCTGTGCATGCCTGTCTTGGGCTTTAGCATGTTGGATAGACTTCTCTGAAATGCATTTGTGAGCATTGCAAGTGACTTGCTTTGTTGGGTTTAATAGGTGTCAT
ASV606	ITS2 Extracted ITS2 sequence 56-251 (196 bp)	AATTCTCAACCCTCTTCATTTTTTATGAATGAAGCAGTGGCTTGGACTTGGAGGTTTTTTGCCGGGCCTCACCGCTCGGCTCCTCTCAAATGCATTAGTGCGTCTTGTTGCGACGTGCGCCTCGGTGTGATAATTATCTACGCTGTGGTGCGCTTGCTTCTGTGGAGACGCGCTTTCTAACCGTCCGAAAGGACAG
ASV607	ITS2 Extracted ITS2 sequence 56-251 (196 bp)	CAAACCCTCTATCCAACTTTTGTTGAATAGGATGACTGAGAGTCTCTTGATCTTTCGATCTCGAACCTCTTGAAATGTACAAAGGCCTGATCTTGTTTGAATGCCTGAACTTTTTTTTAATATAAAGAGAAGCTCTTGCGATAAACTGTGCTGGGGCCTCCCGAATAACACTCTTTTAAATTTGATCTGAAATCAG
ASV608	ITS2 Extracted ITS2 sequence 56-219 (164 bp)	CACCACTCAAGCATAGCTTGGTATTGGGCAACCGCCCCCGCCAGTCGGGGACGCGCCTCAAACACCTCGGCGGAGCCTCACCGGCTTTGGGCGTAGTAGAATTTCTAATAACGTCCTTTAACGGAGATGGTTCCTTTGCCGATAGAATCTTTTAAATTTTTCTA
ASV609	ITS2 Extracted ITS2 sequence 57-251 (195 bp)	TATCTCTCTCAACAACATCTTTTGTGGATGTATTGAGGACAGATGGAGCTTTATTTATATACTCATGTGTGTTTTCAACACATGCGTGCTCTTGAAACACAGCAAGCTCCCCTGACTTTTAGGAACAGTCCTGACTGCGCGGGTGATTATTGGCGTCGTAGCAATCCATACTGTCTTCTCGCGAGAGAAACCAGT
ASV610	ITS2 Extracted ITS2 sequence 56-251 (196 bp)	CCTTCTCAAACATTCTGTTTGGTAGTGAGTGATACTCTTTGGAGTTAACTTGAAATTGCTGGCCTTTTCATTGGATGTTTTTTTTTTCCAAAGAGAGGTTTCTCTGCGTGCTTGAGGTATAATGCAAGTACGGTCGTTTTAGGTTTTACCAACTGCGGCTAATCTTTTTTATACTGAGCGTATTGGAACGTTATCG
ASV611	ITS2 Extracted ITS2 sequence 56-251 (196 bp)	AATTCTCAACCCTCCTCACTTTTTGTGATTGAGGGATTGGACTTGGAGGCCTTGCCGGACTTTTCGTTCGGCTCCTCTCAAATGCATTAGTGCGTCTTGTTGCGACGTGCGCCTCGGTGTGATAATTATCTACGTCGTGGTGCGCTTGCTTCTGTGGAGACGTGCTTTCAAACCGTCCGAAAGGACAGCTTTCATC
ASV612	ITS2 Extracted ITS2 sequence 56-251 (196 bp)	TCACCCCTCAAGCCCGGCTTGTTGTTGGACGCCGGCGGCGCCTTCGGGCACCGCCCGTCTCAAAGATAATGACGGCGTCTGTGAGGACTCCTGTACACTGAGCTTTCGGGCACGTACTAGGCTAGAAATCCAGACCCGGTCTTCAATCCCAGCCCTCGCGGGCCGGGACTCTTTTACAAGGTTGACCTCGGATCAG
ASV613	ITS2 Extracted ITS2 sequence 56-251 (196 bp)	ATTCTTCAACCTACACTTTTCCTTAGTGGATTGAGTAGTGTTTGGATTTTGAGTGCTTGCTAGTCTCACGACTTGGCTCGCTCGTAATATATTAGCAATTCTAATCAATAATTGGATTGACTCGGTGTAATAGACTATTCGCTGAGGAGTACTTGCTTGCAAGTGGCCAAATATTAACCTGACTTTGCTCCTAATC
ASV614	ITS2 Extracted ITS2 sequence 56-251 (196 bp)	AATTCTCAACTCTCTTGTACTATTTTGTACAAGAGAGCTTGGATTGTGGAGGCTTGCTAGCCACTTTGTTGGGGTCAGCTCCTCTAAAATACATTAGCGGAACCGTTTGCGATCTGCCACAAGTGTGATAAACTATCTACACTGACCGGGGGATTGCTCTGTGTTGTTCAGCTACTAATTGTCTTTATTTGATAAG
ASV615	ITS2 Extracted ITS2 sequence 56-251 (196 bp)	TCATCTCAATCCAACAGCTTTGCGGCTGACTTGGATTGGATTTGGGAGTCTGCCGGCCCTTCCCTGGGTCGGCTCTCCTTGAATGCATGAGTGAGCATCTGGCTCGCGTCGCTGGTGTGATAGTCTTTCATCATTGGCGATGCTTGCCTAACGGGCTTGCTTTCGAACCGTCTTCTCAACGGAGACAAACTTCATT
ASV616	ITS2 Extracted ITS2 sequence 56-207 (152 bp)	AAACCTTCAAGCTCTGCTTGGTGTTGGGCGTTTGTTCTGCCTCCGCGCGTGGACTCGCCTCAAATTCATTGGCAGCCGGTCAGTTGGCTTTCGTGCGCAGCACATTGCGTAGCGGCTCCAGCTTGCCTCCTACCATTAAGCTACTCTACATC
ASV617	ITS2 Extracted ITS2 sequence 56-250 (195 bp)	AATTCTCAACCTTTCTGGCTTTTGCAAGCTAGTTAGGCTTGGATTATGGGAGTTGCTGGCTCTTGGTCAGCTCTTCTGAAATGCATTAGCAAGATCATTGCCTGCTCATCATTGGTATGATAACTATCTATACTATTGAGAGCTGGTTTCCTTCATTGGATGATTTTGCTCCTAACCGTCTTTACTAAGACATCA
ASV618	ITS2 Extracted ITS2 sequence 56-251 (196 bp)	ATCTCTATCCACTTTATACACTCTGTGTAAGAGTCTATAACATTGGGAGTTGGAGGCTTGCAATGCCCTGCTGGTGTAGGCTATTGCTCCTCTTGAATGTATTAGTGAGGCCCTTGTTGCAACTTTCCTATTGTATCATGCAGCCTTTGGTGTGATAATCATTAATTGTTAATACCCTCTGGCTTAACATGAGTGG
ASV619	ITS2 Extracted ITS2 sequence 56-251 (196 bp)	ATTCTCCCATCCCAAGCGGTTTTTATCAAAGAATTGCTAGGCGAAGGGGTTGAGATGGGCGTTGTTATAACTGCTTTTCTTCTCTAGAAAAGCTCGCCCGAAAAACAGCTAACGCCTCTGGGCCACTTTGCATCCGCTTCTCTGAGGGGAGAAGCGGCCAAGCGCGCTCTGATCATCAGGCATAGCATGATACGTC
ASV620	ITS2 Extracted ITS2 sequence 55-251 (197 bp)	ATATATCAACCCTCTTCGGCTTTTTGCATGACGAGTGTTGGATGTGGGGGTTTTTGCTGGACTCTTTCTCTTGAGGTCGGCTCTCCTGAAATACATTAGCAAAACGATTTGTTTACTGCTCATTGGTGTGATAATTATCTACGCTATTGACAGTAAAGCAACAGTTTAGCTTCTAACAGTCCATTGGCTTGGACAAC
ASV621	ITS2 Extracted ITS2 sequence 56-177 (122 bp)	CAACCCTCAAGCACTGCTTGGTATTGGGCTCCGCTGGCTCCAGCGGGCCTTAAAATCAGTGGCGGCGCCGTTTGGGCTCTGAGCGTAGTAAATATCCTCGCTATAGAGACCAGGCGGTTCTT
ASV622	ITS2 Extracted ITS2 sequence 56-251 (196 bp)	AATTCTCAATCTTTCTCTCTTTTAAAGCGAGTTAGACTTGGATTATGGAAGTTGCTGGTTCTCACGAATCGGCTCTTCTCAAATATATTAGCAGTCCTTTGCTGACCGTCATTGGTATGATAATTATCTATACCATTGATAAACGGCTTCCTTTTTGGAATGGCTCTGCTTCTAATCGTCCTTCATGGACAATATT
ASV623	ITS2 Extracted ITS2 sequence 51-251 (201 bp)	CGCATGAAATCAACGTGTGTTTGGCGTGCTTGTTCACGCCTTCCGCACAGTTGCTTTTGAGCTTTCTCACGCAAGTGAGTGGTTCCAAGATCGTGTCATCACAGAATTTGAGGGGTTAGCAGCGCCTTTGGAGACGGTTCAACTGACTTGGTCAGCCGACGCCGATTGCATTCAAACCCACCCAAGTGATAATATTGAGTT
ASV624	ITS2 Extracted ITS2 sequence 56-251 (196 bp)	ATACCTCAAGCTAGAAGTTTTCTTCTTGCTTGGATTTGGACTTTGCCGCTGCCTATCTCTGGCGACGGCTGGTCTTAAATGCATTAGCTGATCCATGCTTGTGTGCTTGGTTCTACTCGGCGTGATAATTATCTGACCGCTGAGGACATTTGCCTTGTGCGAATGGCCAGGTGTGCCTTGGGTTGCTTCTAATCTT
ASV625	ITS2 Extracted ITS2 sequence 56-171 (116 bp)	GAACTATAACGCACTTGGGGATTGTGCCCAGGAGGCTGTCTGCGTCATAGTTTTATGCGCCGGTGAGTCTGCTTGTGGCCTTGCTGTCCAACCATGTCCGAAAGGCATCTTGACGA
ASV626	ITS2 Extracted ITS2 sequence 56-251 (196 bp)	AATTATCAACCTTGCTCGCTTTTACCGGCTTGAGTTAGGCTTGGATGTGAGGGCTTTGCTGGCTTCCTTCAGTGGATGGTCTGCTCCCTTGAAATGCATTAGTGGGATCTCTTGTGGACCGTCACTTGGTTGTGATAATTATCTACGCCTTTTGACTTTGAAGCAAACTTATGGGAACCTGCTTATAACCGTCCTT
ASV627	ITS2 Extracted ITS2 sequence 56-251 (196 bp)	AATCATCAAAACCTTTTCTTTGATCGTTTAGATCGAGAGAAGGATTTTGGACTTGGAGGACCAATGCTCGCTCTCAACTTTTGAAAGTGAGCTCCTCTCAAATAAATTAGTGGGGGTTTGCTTCGCCGATCCTTGACGTGATAAGTTGTTTCTACGTTTTGGATTCGGTTGGACACCTGCTTCTAACTGTCCTATG
ASV628	ITS2 Extracted ITS2 sequence 55-230 (176 bp)	TACACCGCTCGAGCCGTCTTGGCTCGGTGTTGGGGCGCTAGGGGCTACGGCCCCTAGGCTCCCAAAGGCATTGCGCGGCCCTAGGAACAGGACCCGAGCACAGTAAACTCACCGTTGAGCTGCTCCCGGGATACTGCGCCGAGGCGCCAGCCGTAAAACCCCCGACACAGGCCCGC
ASV629	ITS2 Extracted ITS2 sequence 56-250 (195 bp)	GAACTATAACGCACTTGGGGATTGGATGTGGAGGTTTTTGCAGGCCTTGAGTTAGGTCAGCTCCTCTGAAATACATTAGCGGAACCGTTTGCGATCCGTCACAGGTGTGATAATTATCTACGCCAGTGGGTTGCTCTCTTTGTGTTCAGCTGCCAATCGTCCCCCGCAAAGGGACAAGCATATACTGAACTTTTG
ASV630	ITS2 Extracted ITS2 sequence 56-218 (163 bp)	TCCTCCCTCAAACCGCGGGTTTGGTGTTGGACCCAAGTTGTGCGAACAACTGGTCTCGAAGACAATGACGGCGTCCGTGGGACCCTCGGTGCAACGAGCTTTTAGGAGCACGCGTCGAGTTTCAAGGACCTTCCGGGCCGGTCTCCTTTTTACCATCTTACAA
ASV631	ITS2 Extracted ITS2 sequence 56-208 (153 bp)	CAACCCTCCAGCCCGGCTGGTGTTTGGGCCTTCGTCCTCCGGGGCGGGCCTCAAAGACAGGGACGACGCCGCGTCGAAACCCCCGAGCGTATGAGACTCTGTCGCTGCTCGATCGGGACGACCGGTTCGGTCCAACCAACCCATCTTTTTTCA
ASV632	ITS2 Extracted ITS2 sequence 56-208 (153 bp)	CTGCCCTCAAGCACGGCTTGTGTGTTGGGCGCGGTCCCCCCGGGGACCTGCCCGAAAGGCAGCGGCGACGTCCGTCTGGTCCTCGAGCGTATGGGGCTCTGTCACTCGCTCGGGACGGACCTGCGGGGGTTGGTCACCACCATATTTTACCAC
ASV633	ITS2 Extracted ITS2 sequence 56-213 (158 bp)	CACCACTCAAGCCTCGCTTGGTATTGGGCACCGCGGGCGACCGCGCGCCCCAAATTCACCGGCTGAGCCGTCGGTCTCTAAGCGTTGTGGCAACTATCCGCTTGCGAGGCCCGGGCGACCCGGCCGTTAAACCCCCCATCAAAGGTTGACCTCGGATC
ASV634	ITS2 Extracted ITS2 sequence 56-251 (196 bp)	AACCCTCAAACCCAAGTTTTGGATGAAAGTCCTCGACTTGAGTTTGGATTTGGGCGTTTGCCGGTGATGAGCCGACTCGCCTTAAATGAATTAGCTGGATCTGTCTTTACGACTGGTTTGACTTGGCATAATAAGTATTTTGCTGAGGACATCATTCATTTGATGGCCAGGACCTAGGCTCTACCGTCTGCTAACG
ASV635	ITS2 Extracted ITS2 sequence 56-251 (196 bp)	CAAACCCTCTATCCAACTTTTGTTGAATAGGATGACTGAGAGTCTCTTGATCTTTCGATCTCGAACCTCTTGAAATGTACAAAGGCCTGATCTTGTTTGAATGCCTGAACTTTTTTTTAATATAAAGAGAAGCTCTTGCGATAAACTGTGCTGGGGCCTCCCAAATAACACTCTTTTAAATTTGATCTGAAATCAG
ASV636	ITS2 Extracted ITS2 sequence 58-251 (194 bp)	GTCGTTGCCCCCCCCAAACCCCTCGGGAGTTGGGCGGGACGGATGATGGCCTCCCGTGTGCTCTGTCATGCGGTTGGCATAAAAACAAGTCCTCGGCGACTAACGCCACGACAATTGGTGGTTGTCAAACCCTCTGTTGCCTATCGTGTGCGCGTGTCGAGCGAGGGCTCAACAAACCATGTTGCATCGATTCG
ASV637	ITS2 Extracted ITS2 sequence 56-250 (195 bp)	CTACCCTCAAGCACAGCTTGGTTGTTGAGCCAAATTGTCCCCTTTTAATAAAAGGACAGGCTCGAAATGCAGTGGCGATGCCGCGTTCGGTGCCCGAGTGTATGGAGCTCTGTCACACGCTTTTGTGGCCTAACCGGCATTCTGTCGACCATAATTATGTATATAATTATGATTTTATCTAAGATTTGACCTCGG
ASV638	ITS2 Extracted ITS2 sequence 56-206 (151 bp)	TCAACCATCAAGCTCTGCTTGGCATTGGGTGTCCGCCCCCTAAAAAGGGCGCGCCTTAAACCAGTGGGCGGCGGCCTTGAGCCTCAAGCGTAGTAGAATCTCCAGCTTCGAGGTCTCGACGGTATCTCGCCACCAAAACCCCATACTCAAA
ASV639	ITS2 Extracted ITS2 sequence 55-178 (124 bp)	TAGACTCACCTACTCGGGTTTCCGAACTAGGTGCTTTGGACGTCTGCCGCCTTCTGGCTCGTCTTAAATGTCTAAGTGGAATGCGTAATAAGTTTTCGCTCCCTCCACTCTAATTACACTTTAG
ASV640	ITS2 Extracted ITS2 sequence 56-134 (79 bp)	CAACCCTCGAGCCCCCCGGGCTTGGTGTTGGGGATCGGCCGCCGCTCACCCGGCGGCCGGCCCCGAATTATAGTGGCGG
ASV641	ITS2 Extracted ITS2 sequence 56-216 (161 bp)	AATACCTCTCAAGCACCATTGCTTGGTCATGGAAGATGAGTATGCTTGCATTCTCCCTTCTGAAATTCAAAGGCGGATCATCTCATATTCCCTGGCGTAGTAAGTGTTTATCTTTCGCTTGGAGTGTCTGACAGTCTTGCCATCGACCCCCATTATTTCAA
ASV642	ITS2 Extracted ITS2 sequence 56-209 (154 bp)	GTACCTTCAAGCTCTGCTTGGTGTTGGGTGTTTGTCTCGCCTCTGCGTGTAGACTCGCCTTAAAACAATTGGCAGCCGGCGTATTGATTTCGGAGCGCAGTACATCTCGCGCTTTGCACTCATAACGACGACGTCCAAAAGTACATTTTTACAC
ASV644	ITS2 Extracted ITS2 sequence 56-251 (196 bp)	CCTTCTCAAACCTCTGGGTTTGGTAGTGAGTGGTACTCTTTCTGGGTTAACTTGAAAATGCTAGCCATTCGGCTGTTGCTGACTGAGACTCTAGTCCAGTTTGCTGATACTCTGCGTATTAGGTTTTACCAACTCGTAGCGGCATTAGTGAGCGTTATAAAGACTTCAGTTAAAAGTACGGACAGCCTGGCAAACA
ASV645	ITS2 Extracted ITS2 sequence 56-194 (139 bp)	AACCTCACTCCACTTGGGTTTTTGCCTGAGTGGTAGTGTATTGGGTGTTGCCTTGCTAAAGGCTCGCCTTAAAGACATAAGCACCTTGGATGTAATACGTTTCATCCTTCTGGGTGGCTGATAACCCCACATATTCATG
ASV646	ITS2 Extracted ITS2 sequence 56-251 (196 bp)	CATCATCAACCCTCCGGCGGTTTCGCCACCGGGTTGGACTTGGAGGCTGTGCTGGACGCGAGTCCGGCTCCTCTCGAATGCATTAGCTGGAAGCGGGCGGATCGACGCGCTGTGTGATAGTCTTATTCACTGTGCGCCGACCTGCATATATGCGCCGGCTTATAACTACAAACTCTCTAAAGTTTGACCTCAAATC
ASV647	ITS2 Extracted ITS2 sequence 56-251 (196 bp)	GAACTATAACGCACTTGGGGATTGTGCCCAGGAGGCTGTCTTGAAGTGGGGGATGCTTGCCTTTTGTGCTGTCTGTCAGGTAGTCGGCTGTTCCTTTGGGGTCCTGTGTGCACCTGTCTTGGGCTTTGCGCCGGTGAGTCTGCTTGTGGCCTTGCTGTCCAACCATGTCCGAAAGGCATCTTGACGAGCTTGACCT
ASV648	ITS2 Extracted ITS2 sequence 56-251 (196 bp)	ATCTCTCAACCCCTCTTGATTAGCTTCGAGGGGGAGCTTGGATAGTGGGGGTTTGCAGGAAACTTGGACTTTTCATAGTCTAGGATTCGAGCTCTCCTGAAATACATTGGCTTGCGGTCGACTTTCGACTTTGCGCGATAAGGCTTTCGGCGTGATAATGATCGCCGTGTGCTGAAGCGCATGACTGTGAAGTTCC
ASV649	ITS2 Extracted ITS2 sequence 55-175 (121 bp)	TAGACTCTTATACCTAGTTTTCTATGTATGAGCTTTGGACGTTGCCATTCTGTGGCTCGTCTTAAATGTCTAAGTGGAATGCGTAATAAGTTTTCGCTCCCTCCACTCTAATACTCTTTAG
ASV650	ITS2 Extracted ITS2 sequence 56-206 (151 bp)	ACACCCTCAAGCACTGCTTGGTGTTGGGCGTCTGTCCCGCCTTCGCGCGTGGACTCGCCCCAAAGTCATTGGCAGCGGTCTCTGGCACCTCAACGCGCAGTACAATGCGTTCATTGGGGTGCCGTGGGCGCGTCCATAAGCTATTTACCGT
ASV651	ITS2 Extracted ITS2 sequence 56-213 (158 bp)	GTACCCTCAAGCTTTGCTTGGTGTTGGGCGTCTTGTCTCTGGCTTTGCTGGAGACTCGCCTTAAAGTAATTGGCAGCCGGCCTACTGGTTTCGGAGCGCAGCACAAGTCGCACTCTCTATCAGCAAAGGTCTAGCATCCATTAAGCCTTTTTTTCAAC
ASV652	ITS2 Extracted ITS2 sequence 56-251 (196 bp)	ACCTCTCAAACCCAAGTTTTGGATTTATCCTTGCTTGAGTTTGGATTTGGGTGTTTGCCAGTGATGAACTGACTCACCTTAAAAGTATTAGCTAGATCTGTCTTTGACTGGTTTGACTTGGCATAATAAGTATTTTGCTAAGGACATCTTCGGATGGCCAGGACTTGACTTTTGTCTGCTTACTAAACCTTACTTT
ASV653	ITS2 Extracted ITS2 sequence 56-251 (196 bp)	AACACCTCAAATTCCAAGATTTGTTTCTTGGGGTTTGGATTTGAGTAATCCTAACGAGAAGGCATTCGCCAACTTGGCAGGTCACTTGAAATGCAGGTGCAGCTGAACATTCTTCTGAGCTAAAAGCATATTTATTTAGTCCTGTTGACTCTTTAAGAGTTTGCGGATTATTACTTTTGCTGCAGCTAACATAAAG
ASV654	ITS2 Extracted ITS2 sequence 56-204 (149 bp)	CACCACTCAAGCCTCGCTTGGTATTGGGCGACGCGGTCCGCCGCGCGCCTCAAATCGACCGGCTGGGTCTTCTGTCCCCTCAGCGTTGTGGAAACTATTCGCTAAAGGGTGCCACGGGAGGCCACGCCGAAAAACAAACCCATTTCTAA
ASV655	ITS2 Extracted ITS2 sequence 56-251 (196 bp)	TCCTCCCTCCAAAACCCCTGCTTTACCGCGGGGGTTTCGGGTGTTGGACCGCGTTGGACCGTTCGCGGCCAACTGGTCTCAAAGACAATGACGGGCGTCCATGGGACCCTCTTCGCACTGAGCTTTCCGGAGCACGCGTCGAGTTGCAAGGTCTTGTGGGCCCGGCCACCTCTAAATCTATTTTTTCAGGTTGACC
ASV656	ITS2 Extracted ITS2 sequence 56-251 (196 bp)	CAAACTCCAAGCTGTGGCTTGATGTTGGATGCTGTCTTTTTGGTGAAAGGAGAGACACATCTGGAACGTGTGGGCGCCGCCGCCAGACCACGAGCGTAGCAAGACGAAAGTCAGTCGTTCGATTTGGATCTGTCTGTGGTTGTCTGTCTGTCGGGGTCTGTTCTTTGGAATTCTGAAGAACAGGCGACGTACAACA
ASV657	ITS2 Extracted ITS2 sequence 56-251 (196 bp)	AATTCTCAACCATGTCTTGGAGACATTACATGGCTTGGATGTTGGGGGGTTTGCTGGCATTCCCAAGATTGTCAGCTCTCCTGAAATGCATTAGCAAAATGGCAGACATACACGGCCTTCCGACGTGATAATGATCGTCGTGGCTGGAGTGTCAGACGCCCATGTTGCTTCCAATCGAGCGTGTTTAGCTACTAGT
ASV658	ITS2 Extracted ITS2 sequence 56-203 (148 bp)	CACCCCTCCAGCCTCGCTGGTGTTTGGGCGTCGCGGATGCACAGTCTGCGCGCCTTAATGTCGCCGGCCGGACCGACCGTCTCTAAGCGTTGTGGTAACAGTTCGCTTGCGGGCACGGGAGGGACGTAGCCGTTAAACCTCTATCACA
ASV659	ITS2 Extracted ITS2 sequence 56-209 (154 bp)	GTACCCTCCAGCCCTGCTGGGTGTTGGGCGTTTTGTTCCGCTGCGCGCGTGAACTCGCCTCAAATGCATTGGCAGCCCGCCGTCCTGTGTGGGAGCGCAGCACATTTTGCGCTCTCCACTGCTGACGGTGGCATCCACAAGTCTACCATTTTAC
ASV660	ITS2 Extracted ITS2 sequence 56-211 (156 bp)	GTACCTTCAAGCTATGCTTGGTGTTGGGTGTTTGTCCTCTCCACTGCGTTTGGACTCGCCTTAAAGTAATTGGCAGCCAGTGTATTGGTATTGAAGCGCAGCACAATTTGCGATTCTAGCTGATAATCACTAGCGTCCATTAAGTACCTATAACAC
ASV661	ITS2 Extracted ITS2 sequence 56-216 (161 bp)	CTACCATTCAAGCTTGCTTGGTTTTGGGTATTGTAGCACTCTCAACTTAGGGTTTTACATATCTTAAATGTAGACGGCAGCAAGTATAAGTTCTGAGCGTAGTAGTAATAACATTTCGCTTTTAGAAACTTATATTTGTTAACCGGAAAAGTATATTTACA
ASV662	ITS2 Extracted ITS2 sequence 56-251 (196 bp)	AATCATCATGGTCATGATCTTTAATTAATCATGGCTTGGTTTTGGAGGTTATGTTGGCTTTTTATTAAGTTGACTCCTCTTAAATACATTAGCTCAGTGTTTAATGCTTAGAGCGGTTCACGGTGTGATAATTATCTACACTTCAACCAATTTAAGTTAGCTGGCTTCTAATCGATCCTTAGTGATCACTTTGTGT
ASV663	ITS2 Extracted ITS2 sequence 56-204 (149 bp)	ATAACTCAAGCCCTAGGCTTGGTGATGGGCAATGCCAGCTAGGCATGCCTGAAAATCAGAGGCAGTGAAGCCTGAGTGCGGAAGCGTAGTGATAATTTTATAACCGCTTAGGCCTCAGGTGAAGCTCGCAGAACACCAAAACTCTTGTT
ASV664	ITS2 Extracted ITS2 sequence 56-251 (196 bp)	AAACCCATCGCGTCGCGGATTGTCATGATCTGCGGGGCGGATTTGGACGCTGCCGTAGTTGGCTCGTCTCGAAATGCATTAGCCAGTCCGAGGACGCGCGCCACTGGTGTGATAATTCACTTTGCGCCGCTGGTGTGTCCGACGAAGGCTCATAATCGCCCGCAAGGGCAACATTTTAATGCTCTGGCCTCAAATC
ASV665	ITS2 Extracted ITS2 sequence 55-251 (197 bp)	CCACACCCTCGCTTCTCTTTTTTCTTGCCAAAAAGGAGAGCGGACCTGGCTGTCTCGATGCCAATCGAGTCCGCTGAAGAACAGAGGCCCGAGCGCGCCTCGCCACGGGCAACAGTCTGGTAGGTGGTAGCAATACCGCATGCCGCTGTTGGCCTGAGTGTGCGCTGGAAGCCATGCAGGAAACCCCAAAAAAAACA
ASV666	ITS2 Extracted ITS2 sequence 56-251 (196 bp)	TTCATCTCACACAACCAATGGTTTTTAAAAGCTGTAATGGCGCCAAGTGGTTATTGTGGTATTGAGTGTCTTCCCACTTGTTAAACGAGAGGGTCACTTGAAATACTTGGTAACTTTCATGAGTCCAAGAATGCTTCGCTATATGTCTTGAAATGCTCAAAGTACCGCTAAGTTTAAGCCTTTACTGGTCACTCTT
ASV667	ITS2 Extracted ITS2 sequence 55-251 (197 bp)	CAATCTATCACACCCTATGGTGTGGATTTGAATGACTTTGTGTAAAAGCAATCATTTTAAATGGAGATCGGTACGTCCATGATGTGAAGGACTTTTGCGCCGGATGCTCAAGACTTGTCTTTTGTCTGGCAACGAGTTCTTCACTTTGGAGTCTGCGACTGAAAGCATTGGGTAGGATTTAACCCCGACATCAATGC
ASV668	ITS2 Extracted ITS2 sequence 56-212 (157 bp)	TCACTAATCAAGCTGGGCTTATTGTTGGACTTCTTGTCGTTAACAGACAGGTCCCAAAGATAATGACGGCGTCAATTAGACCCTAGATGCAACGAGCTTTCATTAGCACGCATTTTAGCTAAGCCTATTGACCCGGTCTTTTTTAACCAATTTCTAA
ASV669	ITS2 Extracted ITS2 sequence 55-251 (197 bp)	CCACACCCTCGCACTTCTCTCCTTTTGAGAAGAAGAGCGGACCTGGCTGTCTCGATGCCAATCGAGTCCGCTGAAGAACAGAGGCCCGAGCGCTGCTCACCATGGGCAACAGTCTGGTAGGTGGTAGCAATACCGCATGCCGCTGTTGGCCTGAGTGCGCGCTGGAAGCCCATGCAGGATAACCCAAAAAAAACATT
ASV670	ITS2 Extracted ITS2 sequence 55-196 (142 bp)	TACCTCTTCAAGCTCTGCTTGGTGTTGGGTGCTTGCCTAGCTAGGCTCACCTTAAAGAGATGAGTGCTTGCGAGGCCCGTAAGTAGCGGAGTAGAACCTGCTTCCTAGGGGCTGTTCGGGGCACTGTAAACTTACTTTCACC
ASV671	ITS2 Extracted ITS2 sequence 57-134 (78 bp)	CGACCCTCAAGCCCCGGCTTGGTGATGGGCTCCCGCCGCGTGGCGGGCCCGAAACCCGTAGGGCGCCGCGGCAGCGGG
ASV672	ITS2 Extracted ITS2 sequence 56-251 (196 bp)	TCACCCTTCAAGCCCTGCGCTTGGTGTTGGACGGCTTGGTCGCATATCTCGTTCGACCCCTCCCAAAGACAATGACGGCGGCCCGCGGTTCCCCCGGTACACTGAGCTTTTTAACTGAGCACGTATCGGACAAGGGCGCCCGGGTCACGGTCCTCTCCCGTAACGGGAAACACTTTTAACTAAGGTTGACCTCGGA
ASV673	ITS2 Extracted ITS2 sequence 55-180 (126 bp)	TAAACCTCACCTCTATAGTTTTCTATAGTTGTGCTTTGGGTGTTTGCCATTTATTTGGCTCGCCTTAAATGTCTAAGTGGAATGCGTAATAAGTTCTCGCAACCCTCCACTCTAATACACTTTATA
ASV674	ITS2 Extracted ITS2 sequence 56-80 (25 bp)	CTCTCTCAAACCCCCGACTTCTGAA
ASV675	ITS2 Extracted ITS2 sequence 56-186 (131 bp)	GAACTATAACGCACTTGGGGATTGTGCCCAGGAGGCTGTCTTGAAGTGGGGAATGCTTGCCTTTTGTGCTGTCTGTCAGGTAGTCGGCTGTTCCTTTGGGGTCCAACCATGTCCGAAAGGCATCTTGACGA
ASV676	ITS2 Extracted ITS2 sequence 56-251 (196 bp)	CCTTCTCAAACAATTATGTTTGGTTGTGAGTGATACTCATTGAGTTAACTTAAAATTGTTAGCCGATTAGGCTGTTATGCTGATTTGGATTAAGATATAAAAGTTTCTATCCAGTCTGCTAATACAAAATTGTCGTATTAGGTTTTACCAACTTCGGCAGGACTTGTGTTTTCAGGCGCTATAAAGATTTTAACCA
ASV677	ITS2 Extracted ITS2 sequence 56-250 (195 bp)	AATTCTCAACCAATCTCTCTTGATTAATCTTTAATCTTCAAGGGGAGCTATGGCTTGGAGTTGGGAGTTGCTGGCATGACTGTCAGCTCTCCTTAAATGTATTAGCAATCGAGTTGGCTAGTCTTTGACGTGCACGGCCTCAGACGTGATAATGATCGTCGTAGCTGGAGCGTCTTTTCTAGACTATGCACATAG
ASV678	ITS2 Extracted ITS2 sequence 56-129 (74 bp)	CACACCCATCAAGCCCGGCTTGTGTGTTGGACCCGTGGTCCCTGGCCCCCTCCGTTCTCTCGGCGGGCCGGGCC
ASV679	ITS2 Extracted ITS2 sequence 61-250 (190 bp)	ATTGTTTCGAACGACAGCTTTCTTATTTAGTTGAGAAAGCTGGCGGATCGGTATTGAGGGTCTTGCCATCTTCCACGGTGGCTCCCTCGAAATGCATTAGCGCATCCATTCGATAGGCAAGACGGACGAAAGCTCGTTATTTCGCCCACGTCTTTCCCTGCCGGGTTTTGATAATATCAGGACTTCGGAG
ASV680	ITS2 Extracted ITS2 sequence 56-224 (169 bp)	CAACCCTAAAGCCTAGCTTTGTGTTGGGAGACTGCGCTAAACCGCAGCTCCTCAAAACCAGTGGCGGAGTCCTCTCGTGCTCTGAGCGTAGTAATTACTTATCTCGCTTCTTGTAACACGGTGGTCGACGGCCAGTAAACCGCACTCCTTCGGGGGGCACTTTTTTAAT
ASV681	ITS2 Extracted ITS2 sequence 56-250 (195 bp)	TAATCTCACTCCGACAACTTTATTGTTGTCTGGAGGTGGACTTGGACCTTGCCGTGTCACAACGGCTGGTCTGAAATGGATGAGTGCACCCTGCTGTAGCAGCGTCTTCAGTGTGATAAGTATCTTCACTGATTCAAGTTCCCTCGGGACACGCTTGTCTGGTGGGCTCTGGGCTTCTAACCGTCCGCATGGACA
ASV682	ITS2 Extracted ITS2 sequence 56-203 (148 bp)	GACCATTCAAGCTCAGCTTGGTGTTGGGTGCTTGTCCTCCCCCCGTGGTGGACTCACCTCAAATGCATTGGCGGCCGGCATGTTGGCTTCGAGCGCAGTAGAAACGCGCCTGTCCTGACGTGCCCGTCCTCCACAAGGCCTTTTTTAA
ASV683	ITS2 Extracted ITS2 sequence 56-251 (196 bp)	TAATCTCAATACAACATTTTTGTAACTAAAAAGTGTTAATATTGGACTTGGGGACTGCTGGCGTAAGTCGGCTTCTCTTGAATGCATTAGCTGGGCTTTTGCTCGAGTAATTGGTGTAATAGTTTCTAACATTCACCGTTTACACTTGCTAATAGAGTCTGCTTCTAATCGTCTTGTAATGAGACAAACACTTAAC
ASV684	ITS2 Extracted ITS2 sequence 55-251 (197 bp)	AATACTTCAACCCTCCTCTTTCTTAATGATTGAAGAGGTGTTTGGTTTCTGAGCGCTGCTGGCCTTTACGGTCTAGCTCGTTCGTAATGCATTAGCATCCGCAATCGAACTTCGGATTGACTTGGCGTAATAGACTATTCGCTGAGGAATTCTAGTCTTCGGACTAGAGCCGGGTTGGGTTAAAGGAAGCTTCTAAT
ASV685	ITS2 Extracted ITS2 sequence 56-202 (147 bp)	CACCACTCAAGCCTAGCTTGGTCTTGGGCGCCGCGGTTCGCCGCGCGCCTTAATGTCTCCGGCTGAGCCATCTGTCTCGAAGCGTTGTGATCAATCAAATCGCTTACGGGTACGGGTGACTTGGGCCGTTAAACCCCCCATTTTACA
ASV686	ITS2 Extracted ITS2 sequence 61-251 (191 bp)	ATTTCTTCGAGCGACAGCTTTTTTCACAAAGGGCTGGCGGATCGGTTTTGAGGGCTTGCCATTTGCCTTGGCTCCCTCTAAATGTATTAGCTGGATTGCAGATCGAGGATGGAAGGATATACGTCCCTCTCCCTTCGGATTTTGATAATTATCAAGAGACGACGGTGATGGAAACTCCCCCGACTTCGGAC
ASV687	ITS2 Extracted ITS2 sequence 56-126 (71 bp)	CAACCATCAAGCTCTGCTTGCGTTGGGGATCCGCGTCTGACGCGGTCCCTCAAAAACAGTGGCGGGCTCGC
ASV688	ITS2 Extracted ITS2 sequence 56-251 (196 bp)	AAATTCTCAAAACCTACATTTGATTATGTGGTGGTTTTGGACTATGGGATTGCTGGTTCTCGTTGTAGACTAGCTCTCCTGAAATGCATGAGTAAGGATTAATGCAATATATGCTCTATGGTGTGATAAGATGGGAATGTCGAACACCCTTGGAGTTGTTGTATAGCCTGCTATCTAACAGTCCGTTGGACAAATC
ASV689	ITS2 Extracted ITS2 sequence 56-207 (152 bp)	CTACCTCAAGCGTTGGCTTGGTGTTGGGTGCCGTCCCCCGCGGACGCATCTGGAAATCAGCGGCGATGCGGCCGGCGACCAAGCGCAGTACAACCACTTCCGCTTCGGTGCCCCGGGCGCGTCCGCCGGACAACCCCCCGTTCTTTCACCAC
ASV690	ITS2 Extracted ITS2 sequence 56-186 (131 bp)	GTGTAATAAGGCTTTGCCTTGCGTTGATCGAGCCTGTCGAAGGCCGATCGAAACACATCGGCGCCTGCTCATGGTCCGAATCGCAGCGATATGCGGGAAGGATCGTGGGTGGGTCGTCCATCTTCTCCAAA
ASV691	ITS2 Extracted ITS2 sequence 56-194 (139 bp)	CTATATCACTCTGATCCGATTGCATCCACGTGCAGTCGGTCGACATGGGCCTTCAGCACTGATCGCCTCGAATTGCTCGCGATCGTCGTGGTAGACAAGGGGTGGATGCCATCCAGTGTTGTCGACGATCAACCCGTGC
ASV692	ITS2 Extracted ITS2 sequence 56-251 (196 bp)	CATCCTCAAACCTTCTTGGTTTCTTGACTAGGAAGGCTTTGGACTTTGGGGGCTTTTGCTGGCCTTCTCTTGTTGAAGCCAGCTCCTCTGAAATGAATTAGTGGGGTCTGCTTTGCTGATCCTTGACGTGATAAGATGTTTCTACGTCTAGGGTTAGCACTGTTTGCTCTAGATCCTGCTTCTAATTGTCTTATGG
ASV693	ITS2 Extracted ITS2 sequence 56-251 (196 bp)	GAACTATAACGCACTTGGGGATTGTGCCCAGGAGGCTGTCTGTCAGGTAGTCGGCTGTTCCTTTGGGGTCCTGCGTGCACCTGTCTTGGGCTTTAGCATGTTGGGTAGGCTTCTCTGAAATGCATTTGTGAGTGTTGCTTGCGACTTGCTCTGTTGGGTTTATAGGCGTCATAGTTTTATGCGCCGGTGAGTCTGC
ASV694	ITS2 Extracted ITS2 sequence 56-159 (104 bp)	GAACTATAACGCACTTGGGGATTTTATAGGCGTCATAGTTTTATGCGCCGGTGAGTCTGCTTGTGGCCTTGCTGTCCAACCATGTCCGAAAGGCATCTTGACGA
